Xv, Xv, Ai, Ai, Aa, Gg, Gg, Rp, Rp, Xv, Rp, Rp, Gg, Gg, Aa, Ai, Ai, Xv, Xv
Xv, Xv, Ms^Vhh, Ai, Ha, 2 Ce, Gg^Fpa, Aa^Fma, Aa^Fpa, Xv, Aa^Fpa, Aa^Fma, Gg^Fpa, 4 Ce, Ha, Ai, Ms^Vhh, Xv, Xv
Xv, Xv, Aa, Ai, Wwf, Gs, Gs, Ha, Gg, Xv, Gg, Ha, Gs, Gs, Wwf, Ai, Aa, Xv, Xv
Xv, Xv, Hhd, Hhd^Fp, Hh^Fp, Wwf, Wwf, Ds, Mm, Xv, Gg, Ds, Wwf, Wwf, Hh^Fp, Hhd^Fp, Hhd, Xv, Xv
Xv, Xv, Gs, Tb^Tf, Ds, Gs, Wwf, Tb^Tf, Ds, Xv, Ds, Tb^Tf, Wwf, Gs, Ds, Tb^Tf, Gs, Xv, Xv
Xv, Xv, Rrc, Rrc, Ss, Gll^Fdw, Wwf, Hh, Ms, Xv, Ms, Hh, Wwf, Gll^Fdw, Ss, Rrc, Rrc, Xv, Xv
Xv, Xv, Ss, Gg, Wwrg, Wwf, Ds, Gs^Vh, Ha, Xv, Ha, Gs^Vh, Ds, Wwf, Wwrg, Gg, Ss, Xv, Xv
Xv, Xv, Gg, Hh, Wwf, Gll^Fdw, Tb^Tf, Hh, Kha, Xv, Kha, Hh, Tb^Tf, Gll^Fdw, Wwf, Hh, Gg, Xv, Xv
Xv, Xv, Gs, Gg^Efm, Ss, Wwf, Wwf, Dd^Do, Kha, Xv, Kha, Dd^Do, Wwf, Wwf, Ss, Gg^Efm, Gs, Xv, Xv
Xv, Xv, Gll^Fp, Gll^Fp, Tb^Tf, Hhd, Gg, Wwf, Kha, Xv, Kha, Wwf, Gg, Hhd, Tb^Tf, Gll^Fp, Gll^Fp, Xv, Xv
Xv, Xv, Gs, Hh^Vhh, Hh, Mm, Wwf, Wwf, Rp, Xv, Rp, Wwf, Wwf, Mm, Hh, Hh^Vhh, Gs, Xv, Xv
Xv, Xv, Gg, Ss, Wwf, Wwf, Gd, Rp, Tb^Tf, Xv, Tb^Tf, Rp, Gd, Wwf, Wwf, Ss, Gg, Xv, Xv
Xv, Xv, Gg, Hh, Wwf, Gg, Tb^Tf, Ds, Dd^Do, Xv, Dd^Do, Ds, Tb^Tf, Gg, Wwf, Hh, Gg, Xv, Xv
Xv, Xv, Wwf, Wwf, Rrc, Wwf, Wwf, Mm, Ds, Xv, Ds, Mm, Wwf, Wwf, Rrc, Wwf, Wwf, Xv, Xv
Xv, Xv, Wwf, Hh, Dd^Do, Hh, Wwrg, Dd^Vdt, Ds, Xv, Ds, Dd^Vdt, Wwrg, Hh, Dd^Do, Hh, Wwf, Xv, Xv
Xv, Xv, Kh, Gs, Wwf, Wwf, Gd, Gg^Fp, Gd, Xv, Gd, Gg^Fp, Gd, Wwf, Wwf, Gs, Kh, Xv, Xv
Xv, Xv, Kh, Wwf, Hh^Fp, Ds, Hhd, Gg^Efm, Ss, Xv, Ss, Gg^Efm, Hhd, Ds, Hh^Fp, Wwf, Kh, Xv, Xv
Xv, Xv, Kh, Hh^Fp, Ds, Tb^Tf, Gd, Dd^Do, Hh, Xv, Hh, Dd^Do, Gd, Tb^Tf, Ds, Hh^Fp, Kh, Xv, Xv
Xv, Xv, Gs, Wwf, Wwf, Ss, Gg^Fp, Tb^Tf, Ds, Xv, Ds, Tb^Tf, Gg^Fp, Ss, Wwf, Wwf, Gs, Xv, Xv
Xv, Xv, Tb^Tf, Hh^Fp, Ss, Wwf, Wwf, Gg^Fp, Wwf, Xv, Wwf, Gg^Fp, Wwf, Wwf, Ss, Hh^Fp, Tb^Tf, Xv, Xv
Xv, Xv, Gs, Hh, Ss, Gs^Gvs, Wwf, Ww^Vm, Dd^Ftd, Xv, Dd^Ftd, Ww^Vm, Wwf, Gs^Gvs, Ss, Hh, Gs, Xv, Xv
Xv, Xv, Mm, Tb^Tf, Hhd, Ds, Gs, Wwf, Wwf, Xv, Wwf, Wwf, Gs, Ds, Hhd, Tb^Tf, Mm, Xv, Xv
Xv, Xv, Gll^Fdf, Gd, Gs, Dd^Do, Gg^Fdf, Hh, Wwf, Xv, Wwf, Hh, Gg^Fdf, Dd^Do, Gs, Gd, Gll^Fdf, Xv, Xv
Xv, Xv, Tb^Tf, Gg^Fmf, Gg, Gg, Wwf, Wwf, Kh, Xv, Kh, Wwf, Wwf, Gg, Gg, Gg^Fmf, Tb^Tf, Xv, Xv
Xv, Xv, Gg, Hh, Wwf, Wwf, Hh, Gs, Kh, Xv, Kh, Gs, Hh, Wwf, Wwf, Hh, Gg, Xv, Xv
Xv, Xv, Wwf, Hh^Vhh, Wwf, Ss, Rp, Hhd, Kh, Xv, Kh, Hhd, Rp, Ss, Wwf, Hh^Vhh, Wwf, Xv, Xv
Xv, Xv, Gg^Fdf, Wwf, Wwf, Ds, Ss, Hhd, Gd, Xv, Gd, Hhd, Ss, Ds, Wwf, Wwf, Gg^Fdf, Xv, Xv
Xv, Xv, Hh, Gs, Ss, Wwf, Wwf, Ds, Hh^Fdf, Xv, Hh^Fdf, Ds, Wwf, Wwf, Ss, Gs, Hh, Xv, Xv
Xv, Xv, Ss, Hh, Tb^Tf, Gg, Wwf, Gs, Mm, Xv, Mm, Gs, Wwf, Gg, Tb^Tf, Hh, Ss, Xv, Xv
Xv, Xv, Gs, Dd^Do, Wwf, Wwf, Hh, Gs, Rp, Xv, Rp, Gs, Hh, Wwf, Wwf, Dd^Do, Gs, Xv, Xv
Xv, Xv, Hh^Fp, Gs, Wwf, Gg, Hh, Gg^Fms, Gg^Fds, Xv, Gg^Fds, Gg^Fms, Hh, Gg, Wwf, Gs, Hh^Fp, Xv, Xv
Xv, Xv, Kh, Gg, Hh^Fp, Wwrg, Ds, Gg^Ve, Gg^Fds, Xv, Gg^Fds, Gg^Ve, Ds, Wwrg, Hh^Fp, Gg, Kh, Xv, Xv
Xv, Xv, Kh, Gd^Fts, Rp, Wwf, Gd, Gd, Gg^Fms, Xv, Gg^Fms, Gd, Gd, Wwf, Rp, Gd^Fts, Kh, Xv, Xv
Xv, Xv, Kh, Gg, Wwf, Wwf, Hh, Gs, Gs, Xv, Gs, Gs, Hh, Wwf, Wwf, Gg, Kh, Xv, Xv
Xv, Xv, Hh^Fp, Wwf, Gd^Fts, Gd^Fts, Ds, Gd^Fts, Dd^Do, Xv, Dd^Do, Gd^Fts, Ds, Gd^Fts, Gd^Fts, Wwf, Hh^Fp, Xv, Xv
Xv, Xv, Wwf, Wwf, Rp, Gs, Ds, Gd^Fts, Gs, Xv, Gs, Gd^Fts, Ds, Gs, Rp, Wwf, Wwf, Xv, Xv
Xv, Xv, Wwrg, Rp, Gs, Ds, Hhd, Dd^Vda, Dd^Ftd, Xv, Dd^Ftd, Dd^Vda, Hhd, Ds, Gs, Rp, Wwrg, Xv, Xv
Xv, Xv, Wwf, Gg^Ft, Wwf, Hhd, Ds, Gd, Ds, Xv, Ds, Gd, Ds, Hhd, Wwf, Gg^Ft, Wwf, Xv, Xv
Xv, Xv, Gs, Wwf, Mm, Wwf, Wwf, Gd, Hhd, Xv, Hhd, Gd, Wwf, Wwf, Mm, Wwf, Gs, Xv, Xv
Xv, Xv, Hh, Dd^Do, Gs, Ss, Hh, Wwf, 1 Kh, Xv, 3 Kh, Wwf, Hh, Ss, Gs, Dd^Do, Hh, Xv, Xv
Xv, Xv, Ds, Rp, Gs, Gs, Ds, Wwf, Kh, Xv, Kh, Wwf, Ds, Gs, Gs, Rp, Ds, Xv, Xv
Xv, Xv, Gs, Hh^Ft, Wwf, Mm, Wwf, Gs, Gg, Xv, Gs, Gs, Wwf, Mm, Wwf, Hh^Ft, Gs, Xv, Xv
Xv, Xv, Gg, Gs, Rp, Rp, Gg, Gg, Gg, Xv, Gg, Gg, Gg, Rp, Rp, Gs, Gg, Xv, Xv
