Xv, Xv, Gg, Gg, Gs, Gg, Gg, Gg, Gs, Gg, Xv, Gg, Gs, Gg, Gg, Gg, Gs, Gg, Gg, Xv, Xv
Xv, Xv, Gs, Gs^Vh, Gg, Gs, 2 Ce, Gs, Gs, Gd, Xv, Gd, Gs, Gs, 4 Ce, Gs, Gg, Gs^Vh, Gs, Xv, Xv
Xv, Xv, Gg, Gd, Gs, Rrd, Rrd, Rrd, Gs, Gs, Xv, Gs, Gs, Rrd, Rrd, Rrd, Gs, Gd, Gg, Xv, Xv
Xv, Xv, Ss, Gs^Ft, Gs^Ft, Rrd, Rrd, Gg, Hh^Ft, Gg, Xv, Gg, Hh^Ft, Gg, Rrd, Rrd, Gs^Ft, Gs^Ft, Ss, Xv, Xv
Xv, Xv, Gs^Eff, Ss^Ft, Ss, Rrd, Rrd, Hh^Ft, Hh, Hh, Xv, Hh, Hh, Hh^Ft, Rrd, Rrd, Ss, Ss^Ft, Gs^Eff, Xv, Xv
Xv, Xv, Gg, Gs^Eff, Gg^Eff, Gs^Eff, Gs, Gs, Gd^Fts, Gd^Fts, Xv, Gd^Fts, Gd^Fts, Gs, Gs, Gs^Eff, Gg^Eff, Gs^Eff, Gg, Xv, Xv
Xv, Xv, Gs, Gs^Ftp, Gg, Gg, Gs, Gs, Gs, Gd^Fts, Xv, Gd^Fts, Gs, Gs, Gs, Gg, Gg, Gs^Ftp, Gs, Xv, Xv
Xv, Xv, Gs, Gs^Ftp, Gs^Ftp, Gg, Gd^Fts, Gd^Fts, Md, Gs, Xv, Gs, Md, Gd^Fts, Gd^Fts, Gg, Gs^Ftp, Gs^Ftp, Gs, Xv, Xv
Xv, Xv, Gd, Gs, Gs, Gs, Gd^Fts, Md, Md, Md, Xv, Md, Md, Md, Gd^Fts, Gs, Gs, Gs, Gd, Xv, Xv
Xv, Xv, Gll^Fmw, Gd, Rb, Gs, Qxe, Qxe, Qxe, Md, Xv, Md, Qxe, Qxe, Qxe, Gs, Rb, Gd, Gll^Fmw, Xv, Xv
Xv, Xv, Gll^Fmw, Gll^Fmw, Rb, Gd, Gd, Gd, Gd, Gd^Vhr, Xv, Gd^Vhr, Gd, Gd, Gd, Gd, Rb, Gll^Fmw, Gll^Fmw, Xv, Xv
Xv, Xv, Cea, Cea, Sm, Rb, Ms, Ms, Ms, Gd, Xv, Gd, Ms, Ms, Ms, Rb, Sm, Cea, Cea, Xv, Xv
Xv, Xv, Kea, Sm, Ai, Rb, Wwf, Ms, Wwg, Aa^Fpa, Xv, Aa^Fpa, Wwg, Ms, Wwf, Rb, Ai, Sm, Kea, Xv, Xv
Xv, Xv, Rb, Sm, Wwrg, Wwrg, Ha, Wwg, Ai, Sm, Xv, Sm, Ai, Wwg, Ha, Wwrg, Wwrg, Sm, Rb, Xv, Xv
Xv, Xv, Gd, Hhd, Aa^Fpa, Gd, Rb, Rb, Ai, Sm, Xv, Sm, Ai, Rb, Rb, Gd, Aa^Fpa, Hhd, Gd, Xv, Xv
Xv, Xv, Aa, Gll^Fdw, Rb, Gll^Fdw, Aa, Gd, Gd, Sm, Xv, Sm, Gd, Gd, Aa, Gll^Fdw, Rb, Gll^Fdw, Aa, Xv, Xv
Xv, Xv, Gll, Gd, Gll, Gll, Sm, Gll, Aa, Aa, Xv, Aa, Aa, Gll, Sm, Gll, Gll, Gd, Gll, Xv, Xv
Xv, Xv, Gd^Vo, Aa, Sm, Sm, Sm, Gs, Gs, Sm, Xv, Sm, Gs, Gs, Sm, Sm, Sm, Aa, Gd^Vo, Xv, Xv
Xv, Xv, Gd, Gs, Gs^Ft, Gd, Wwg, Ds, Ds, Ds, Xv, Ds, Ds, Ds, Wwg, Gd, Gs^Ft, Gs, Gd, Xv, Xv
Xv, Xv, Gs^Tf, Wwg, Dd^Do, Gd, Sm, Wwg, Hhd, Uue, Xv, Uue, Hhd, Wwg, Sm, Gd, Dd^Do, Wwg, Gs^Tf, Xv, Xv
Xv, Xv, Rb, Ww^Ewl, Gs^Tf, Uue, Gs, Wwg, Ds, Rb, Xv, Rb, Ds, Wwg, Gs, Uue, Gs^Tf, Ww^Ewl, Rb, Xv, Xv
Xv, Xv, Ds, Wwg, Uue, Uue, Gs^Ft, Wog, Wwrg, Rb, Xv, Rb, Wwrg, Wog, Gs^Ft, Uue, Uue, Wwg, Ds, Xv, Xv
Xv, Xv, Uue, Gd, Gs, Sm, Sm, Gs^Ft, Gs, Gs, Xv, Gs, Gs, Gs^Ft, Sm, Sm, Gs, Gd, Uue, Xv, Xv
Xv, Xv, Uue, Gs^Ft, Sm, Ds, Gd, Ds, Gs^Tf, Wwf^Vwm, Xv, Wwf^Vwm, Gs^Tf, Ds, Gd, Ds, Sm, Gs^Ft, Uue, Xv, Xv
Xv, Xv, Gs, Gs, Uue, Wwf, Gs, Gs, Wwf, Uue, Xv, Uue, Wwf, Gs, Gs, Wwf, Uue, Gs, Gs, Xv, Xv
Xv, Xv, Gs, Gs, Gll^Ftr, Gll^Ftr, Cer, Xv^Ftr, Gs, Gs, Xv, Gs, Gs, Xv^Ftr, Cer, Gll^Ftr, Gll^Ftr, Gs, Gs, Xv, Xv
Xv, Xv, Gd, Gs, Ket, Cer, Ss, Ss^Ftr, Ss, Ss^Ftr, Xv, Ss^Ftr, Ss, Ss^Ftr, Ss, Cer, Ket, Gs, Gd, Xv, Xv
Xv, Xv, Rb, Gd, Gd, Gd, Md, Ss, Ss, Gs, Xv, Gs, Ss, Ss, Md, Gd, Gd, Gd, Rb, Xv, Xv
Xv, Xv, Sm, Rb, Rb, Md, Md, Gd^Vhr, Gll^Fdf, Gs, Xv, Gs, Gll^Fdf, Gd^Vhr, Md, Md, Rb, Rb, Sm, Xv, Xv
Xv, Xv, Sm, Sm, Rb, Re^Fmf, Md, Md, Md, Gd, Xv, Gd, Md, Md, Md, Re^Fmf, Rb, Sm, Sm, Xv, Xv
Xv, Xv, Hhd, Sm, Rb, Rb, Sm, Rb^Fdw, Gll^Fmw, Gll^Fmw, Xv, Gll^Fmw, Gll^Fmw, Rb^Fdw, Sm, Rb, Rb, Sm, Hhd, Xv, Xv
Xv, Xv, Hhd, Hhd, Rb, Sm, Hhd, Sm, Gd, Gd, Xv, Gd, Gd, Sm, Hhd, Sm, Rb, Hhd, Hhd, Xv, Xv
Xv, Xv, Ai, Gd, Cer, Rb, Re, Rb, Cer, Rb, Xv, Rb, Cer, Rb, Re, Rb, Cer, Gd, Ai, Xv, Xv
Xv, Xv, Wwf, Wwf, Aa, Re, Hhd, Rb, Rb, Rb, Xv, Rb, Rb, Rb, Hhd, Re, Aa, Wwf, Wwf, Xv, Xv
Xv, Xv, Wwf, Ai, Wwf, Rb, Rb, Hhd, Re, Gd, Xv, Gd, Re, Hhd, Rb, Rb, Wwf, Ai, Wwf, Xv, Xv
Xv, Xv, Wwg, Wwg, Wwf, Ai, Re, Gd^Fdw, Rb^Fdw, Gd, Xv, Gd, Rb^Fdw, Gd^Fdw, Re, Ai, Wwf, Wwg, Wwg, Xv, Xv
Xv, Xv, Wwg, Wwg, Ww^Vm, Wwf, Rb, Gd, Re, Aa, Xv, Aa, Re, Gd, Rb, Wwf, Ww^Vm, Wwg, Wwg, Xv, Xv
Xv, Xv, Wwg, Wwg, Wwf, Wwf, Ai, Rb, Rb, Gd, Xv, Gd, Rb, Rb, Ai, Wwf, Wwf, Wwg, Wwg, Xv, Xv
Xv, Xv, Wwg, Wwg, Wwf, Ai, Rb, Aa, Re^Fdw, Rb^Fdw, Xv, Rb^Fdw, Re^Fdw, Aa, Rb, Ai, Wwf, Wwg, Wwg, Xv, Xv
Xv, Xv, Wwg, Wwg, Wwf, Wwf, Rb, Re, Cva, 1 Kva, Xv, 3 Kva, Cva, Re, Rb, Wwf, Wwf, Wwg, Wwg, Xv, Xv
Xv, Xv, Wwg, Wwf, Wwf, Ai, Ai, Ai, Ai, Cva, Xv, Cva, Ai, Ai, Ai, Ai, Wwf, Wwf, Wwg, Xv, Xv
Xv, Xv, Wwg, Wwg, Wwg, Aa^Fpa, Ha, Ha, Ha^Vaa, Aa^Fpa, Xv, Aa^Fpa, Ha^Vaa, Ha, Ha, Aa^Fpa, Wwg, Wwg, Wwg, Xv, Xv
Xv, Xv, Wwg, Wwg, Wwg, Aa^Fpa, Aa^Fpa, Aa^Fpa, Aa^Fpa, Aa^Fpa, Xv, Aa^Fpa, Aa^Fpa, Aa^Fpa, Aa^Fpa, Aa^Fpa, Wwg, Wwg, Wwg, Xv, Xv
