Ha, Aa, Ai, Wwf, Wwf, Gll^Emf, Gg, Aa, Gll, Xv, Gll, Aa, Gg, Gll^Emf, Wwf, Wwf, Ai, Aa, Ha
Ha, Ha, Ha, Ai, Wwf, Gll^Fmw, Gll^Fmw, Aa, Gll, 9 Xv, Gll, Aa, Gll^Fmw, Gll^Fmw, Wwf, Ai, Ha, Ha, Ha
Aa, Aa, Aa^Feta, Gll, Wwf, Gll^Fmw, Gll^Fmw, Gll^Fmw, Gll, Xv, Gll, Gll^Fmw, Gll^Fmw, Gll^Fmw, Wwf, Gll, Aa^Feta, Aa, Aa
Ha, Aa^Fma, Wwf, Gll, Gll, 2 Wwf, Gll, Gll, Aa^Fpa, Xv, Aa^Fpa, Gll, Gll, 4 Wwf, Gll, Gll, Wwf, Aa^Fma, Ha
Hhd, Hhd, Wwf, Wwf, Gll, Gll, Gll^Fmw, Aa^Fpa, Aa^Fpa, Xv, Aa^Fpa, Aa^Fpa, Gll^Fmw, Gll, Gll, Wwf, Wwf, Hhd, Hhd
Hhd^Fmw, Hhd, Wwrg, Hh, Re, Re, Ai, Wwf, Aa^Fpa, Xv, Aa^Fpa, Wwf, Ai, Re, Re, Hh, Wwrg, Hhd, Hhd^Fmw
Hhd^Fmw, Hhd^Fmw, Wwg, Hhd^Fmw, Hhd^Fmw, Gll, Gll, Wwf, Aa, Xv, Aa, Wwf, Gll, Gll, Hhd^Fmw, Hhd^Fmw, Wwg, Hhd^Fmw, Hhd^Fmw
Wwg, Wwg, Wwg, Wwg, Wwrg, Gd, Mm, Gs, Gll, Xv, Gll, Gs, Mm, Gd, Wwrg, Wwg, Wwg, Wwg, Wwg
Wwg, Wwg, Wwg, Wwg, Hhd^Fp, Mm^Vhh, Mm^Vhh, Mm^Fms, Gll, Xv, Gll, Mm^Fms, Mm^Vhh, Mm^Vhh, Hhd^Fp, Wwg, Wwg, Wwg, Wwg
Wwg, Wwg, Wwf, Gs, Gll^Fp, Mm^Fms, Gs, Gd, Gd, Xv, Gd, Gd, Gs, Mm^Fms, Gll^Fp, Gs, Wwf, Wwg, Wwg
Wwrg, Wwf, Dd, Wwf, Wwf, Gd, Ce^Fms, Gd, Dd^Do, Xv, Dd^Do, Gd, Ce^Fms, Gd, Wwf, Wwf, Dd, Wwf, Wwrg
Gs^Fds, Gs^Fds, Dd, Dd, Gd, Hh^Fms, Gs, Gs, Gs, Xv, Gs, Gs, Gs, Hh^Fms, Gd, Dd, Dd, Gs^Fds, Gs^Fds
Gs^Fds, Gs^Fds, Gs, Gd, Gs, Gd, Ss, Gs, Hh, Xv, Hh, Gs, Ss, Gd, Gs, Gd, Gs, Gs^Fds, Gs^Fds
Gs, Gs^Vh, Gs, Gs, Gs, Ss, Hh, Gll^Fp, Gs, Xv, Gs, Gll^Fp, Hh, Ss, Gs, Gs, Gs, Gs^Vh, Gs
Gd^Fts, Gd^Fts, Gg, Gll^Ftr, Gs, Gg, Qlf, Hh, Gd, Xv, Gd, Hh, Qlf, Gg, Gs, Gll^Ftr, Gg, Gd^Fts, Gd^Fts
Gs^Ft, Gs^Ft, Gs^Ft, Gs^Ft, Ch, 1 Kh, Ch, Gd, Gll^Fmw, Xv, Gll^Fmw, Gd, Ch, 3 Kh, Ch, Gs^Ft, Gs^Ft, Gs^Ft, Gs^Ft
Gg, Gs^Ft, Dd^Ftd, Gs^Ft, Gll^Ftr, Gs^Ft, Gs^Ft, Gll^Fmw, Gll^Fmf, Xv, Gll^Fmf, Gll^Fmw, Gs^Ft, Gs^Ft, Gll^Ftr, Gs^Ft, Dd^Ftd, Gs^Ft, Gg
