Re, Re, Re, Re, Re, Re, Re, Re, Re, Re, Xv, Re, Re, Re, Re, Re, Re, Re, Re, Re, Re
Rb, Rb, Re, Gll^Fdw, Re, Re, Re, Re, Rb, Rb, 9 Xv, Rb, Rb, Re, Re, Re, Re, Gll^Fdw, Re, Rb, Rb
Re, Gll^Fdw, Gll^Fdw, Re, Re, Rb^Fdw, Rb, Re, Re, Rb, Xv, Rb, Re, Re, Rb, Rb^Fdw, Re, Re, Gll^Fdw, Gll^Fdw, Re
Hhd, Hhd^Fdw, Hhd, Rb, Hhd, Md, 2 Re, Hhd, Re, Md, Xv, Md, Re, Hhd, 4 Re, Md, Hhd, Rb, Hhd, Hhd^Fdw, Hhd
Re, Md, Md, Re, Re, Re, Re^Fdw, Md, Re, Hhd^Fdw, Xv, Hhd^Fdw, Re, Md, Re^Fdw, Re, Re, Re, Md, Md, Re
Re, Rb, Re, Re, Re, Rb, Re, Re, Re, Re, Xv, Re, Re, Re, Re, Rb, Re, Re, Re, Rb, Re
Re, Cer, Re, Re, Cer, Rb, Cer, Re, Rb, Cer, Xv, Cer, Rb, Re, Cer, Rb, Cer, Re, Re, Cer, Re
Wwg, Re^Vct, Wog^Bw\, Wog^Bw|, Wog, Wog, Wog, Wog, Wog^Bw|, Wog, Xv, Wog, Wog^Bw|, Wog, Wog, Wog, Wog, Wog^Bw|, Wog^Bw/, Re^Vct, Wwg
Wwg, Wwg, Wog, Wog^Bw\, Wog^Bw\, Wog, Wwg^Bw/r, Wwg^Bw/r, Wwg^Bw|, Wog, Xv, Wog, Wwg^Bw|, Wwg^Bw\r, Wwg^Bw\r, Wog, Wog^Bw/, Wog^Bw/, Wog, Wwg, Wwg
Hd, Wwg, Wwf^Dr, Wog^Bw|, Wwf^Bw/r, Wwg^Bw/r, Wwg^Bw\, Wwg, Ds, Ww^Vm, Xv, Ww^Vm, Ds, Wwg, Wwg^Bw/, Wwg^Bw\r, Wwf^Bw\r, Wog^Bw|, Wwf^Dr, Wwg, Hd
Hd, Hd, Wwf, Wwf^Bw|, Wwf, Dd^Ftd, Ds, Ds^Ewsh, Hd, Hd, Xv, Hd, Hd, Ds^Ewsh, Ds, Dd^Ftd, Wwf, Wwf^Bw|, Wwf, Hd, Hd
Ds, Dd^Ftd, Dd^Do, Re, Wwf, Wwf, Hd^Ftd, Rb, Dd^Ftd, Hd, Xv, Hd, Dd^Ftd, Rb, Hd^Ftd, Wwf, Wwf, Re, Dd^Do, Dd^Ftd, Ds
Rb, Dd^Ftd, Rb, Rb, Rb, Rb, Rb, Rb, Rb, Dd^Vdt, Xv, Dd^Vdt, Rb, Rb, Rb, Rb, Rb, Rb, Rb, Dd^Ftd, Rb
Rb, Rb, Re, Re, Dd^Ftd, Hd, Rb, Re, Dd^Ftd, Re, Xv, Re, Dd^Ftd, Re, Rb, Hd, Dd^Ftd, Re, Re, Rb, Rb
Ds, Rb, Rb, Re, Rb, Ds, Rb, Re, Re, Ds, Xv, Ds, Re, Re, Rb, Ds, Rb, Re, Rb, Rb, Ds
Ds, Dd^Ftd, Rb, Re, Rb, Cd, 1 Kd, Cd, Re, Ds, Xv, Ds, Re, Cd, 3 Kd, Cd, Rb, Re, Rb, Dd^Ftd, Ds
Ds, Ds, Ds, Ds, Rb, Rb, Re, Re, Ds, Ds, Xv, Ds, Ds, Re, Re, Rb, Rb, Ds, Ds, Ds, Ds
