Rra, Ms, Ms, Ms^Xm, Ms^Xm, Ms^Xm, Aa^Fpa, Gd, Gd, Gd, Aa^Fpa, Aa^Fpa, _off^_usr, Aa^Fpa, Aa^Fpa, Gd, Gd, Gd, Aa^Fpa, Ms^Xm, Ms^Xm, Ms^Xm, Ms, Ms, Rra
Wwf, Rra, Rra, Ms, Ha, Ha, Gd^Fmw, Gd, Gd, Gd^Fmw, Gd^Fmw, Aa^Fpa, _off^_usr, Aa^Fpa, Gd^Fmw, Gd^Fmw, Gd, Gd, Gd^Fmw, Ha, Ha, Ms, Rra, Rra, Wwf
Wwf, Ai^Edt, Rra, Ms, Ms^Xm, Gd^Fmw, Gd, Gd, Gd, Gd, Gd^Fmf, Gd, _off^_usr, Gd, Gd^Fmf, Gd, Gd, Gd, Gd, Gd^Fmw, Ms^Xm, Ms, Rra, Ai^Edt, Wwf
Wwf, Wwf, Rra, Ms, Ms, Aa^Fpa, Gd^Fmf, Gd, Gd, Gd^Fmf, Gd^Fmf, Gd^Fmf, _off^_usr, Gd^Fmf, Gd^Fmf, Gd^Fmf, Gd, Gd, Gd^Fmf, Aa^Fpa, Ms, Ms, Rra, Wwf, Wwf
Wwg, Wwf, Wwf, Rra, Hhd, Gd, Gd^Fmf, Gd, Gd, Hhd^Fmf, Hhd^Fmf, Gd, _off^_usr, Gd, Hhd^Fmf, Hhd^Fmf, Gd, Gd, Gd^Fmf, Gd, Hhd, Rra, Wwf, Wwf, Wwg
Wwg, Wwg, Wwf^Es, Rra, Gd, Gd, Hhd, Hhd^Fmf, Gs, Gd, Gs, Hhd, _off^_usr, Hhd, Gs, Gd, Gs, Hhd^Fmf, Hhd, Gd, Gd, Rra, Wwf^Es, Wwg, Wwg
Wwg, Wwf, Wwf, Rra, Aa^Eff, Gd, Gd, Gs, Gd^Eff, Gs, Gs, Gs, _off^_usr, Gs, Gs, Gs, Gd^Eff, Gs, Gd, Gd, Aa^Eff, Rra, Wwf, Wwf, Wwg
Wwg, Wwg, Wwf, Rra, Rra, Gd^Eff, Gd^Eff, Gs^Eff, Rra, Gd^Eff, Gs^Eff, Gs^Vh, _off^_usr, Gs^Vh, Gs^Eff, Gd^Eff, Rra, Gs^Eff, Gd^Eff, Gd^Eff, Rra, Rra, Wwf, Wwg, Wwg
Wwf, Wwf, Wwf, Wwf, Gll^Fdf, Rra, Rra, Rra, Wwf, Rra, Rra, Gd, _off^_usr, Gd, Rra, Rra, Wwf, Rra, Rra, Rra, Gll^Fdf, Wwf, Wwf, Wwf, Wwf
Wwf, Wwf, Wwf, Ai^Es, Hhd, Md^Fmf, Hhd, Ce, Wwf, Ai, Rra, Gll^Fdf, _off^_usr, Gll^Fdf, Rra, Ai, Wwf, Ce, Hhd, Md^Fmf, Hhd, Ai^Es, Wwf, Wwf, Wwf
Wwg, Wwg, Gd, Gll^Fdf, Gd, Gll^Fdf, Gll^Fmf, Hhd^Fmf, Wwf, Wwf, Rra, Wwf, _off^_usr, Wwf, Rra, Wwf, Wwf, Hhd^Fmf, Gll^Fmf, Gll^Fdf, Gd, Gll^Fdf, Gd, Wwg, Wwg
Gs, Gs^Vh, Gd, Hhd, Wwrg, Aa, Wwf, Wwf, Rra, Rra, Ce, Wwf, _off^_usr, Wwf, Ce, Rra, Rra, Wwf, Wwf, Aa, Wwrg, Hhd, Gd, Gs^Vh, Gs
Gd, Gs, Gs, Gd, Wwg, Wwf, Rrc, Rra, Rra, Ai, Wwf, Wwf, _off^_usr, Wwf, Wwf, Ai, Rra, Rra, Rrc, Wwf, Wwg, Gd, Gs, Gs, Gd
Hhd, Gll^Fdf, Gd, Ww^Vm, Wwg, Wwg, Rrc, Rra, Rra, Aa, Wwf, Wwf, _off^_usr, Wwf, Wwf, Aa, Rra, Rra, Rrc, Wwg, Wwg, Ww^Vm, Gd, Gll^Fdf, Hhd
Gd, Hhd, Gll^Fdf, Gd, Wwf, Wwg, Wwf, Rra, Rra, Rra, Rra, Rra, _off^_usr, Rra, Rra, Rra, Rra, Rra, Wwf, Wwg, Wwf, Gd, Gll^Fdf, Hhd, Gd
Gd, Gd, Gd, Gd, Gd, Wwf, Wwf, Wwf, Rra, Ch, Kh, Cha, _off^_usr, Cha, Kh, Ch, Rra, Wwf, Wwf, Wwf, Gd, Gd, Gd, Gd, Gd
Gd, Gd, Hhd, Gll^Fdf, Gll^Fdf, Gd, Wwf, Wwf, Rra^Vhca, Cha, Ms, Ms, _off^_usr, Ms, Ms, Cha, Rra^Vhca, Wwf, Wwf, Gd, Gll^Fdf, Gll^Fdf, Hhd, Gd, Gd
Gd, Gd, Gd, Hhd, Gd, Gd, Wwf, Wwf, Ms, Ms^Xm, Ms, Ms^Xm, _off^_usr, Ms^Xm, Ms, Ms^Xm, Ms, Wwf, Wwf, Gd, Gd, Hhd, Gd, Gd, Gd
