Wog^Xo, Wog^Xo, Wog^Xo, Wog^Xo, Wog^Xo, Wog^Xo, Wog^Xo, Wog^Xo, Wog, Wog^Xo, Wog^Xo, Wog^Xo, Wog^Xo, Wog^Xo, Wog^Xo, Wog^Xo, Wog^Xo, Wog^Xo, Wog^Xo, Wog^Xo, Wog, Wog^Xo, Wog^Xo, Wog^Xo, Wog^Xo, Wog^Xo, Wog^Xo, Wog^Xo, Wog^Xo
Wog^Xo, Wog^Xo, Wog, Wog, Wog, Wog^Xo, Wog, Wog, Hh, Wog, Wog, Wog^Xo, Wog^Xo, Wog^Xo, Wog^Xo, Wog^Xo, Wog^Xo, Wog^Xo, Wog, Wog, Hh, Wog, Wog, Wog^Xo, Wog, Wog, Wog, Wog^Xo, Wog^Xo
Wog^Xo, Wog, Hh, Hh, Hh, Wog, Wog, Hh, Hh, Hh, Hh, Wog, Wog, Wog^Xo, Wog^Xo, Wog^Xo, Wog, Wog, Hh, Hh, Hh, Hh, Wog, Wog, Hh, Hh, Hh, Wog, Wog^Xo
Wog^Xo, Wog, Hh, Gg, Gg, Ss, Gg, Gg, Gg, Gg, Gg, Hh, Dd, Wog, Wog^Xo, Wog, Dd, Hh, Gg, Gg, Gg, Gg, Gg, Ss, Gg, Gg, Hh, Wog, Wog^Xo
Wog^Xo, Wog, Wog, Gg, Gg, Gg, Gg, Gg, Gg, Gg, Ss, Hd, Hd, Dd, Wog^Xo, Dd, Hd, Hd, Ss, Gg, Gg, Gg, Gg, Gg, Gg, Gg, Wog, Wog, Wog^Xo
Wog^Xo, Wog^Xo, Wog, Ss, Gs^Fds, Ss, Gg, Gs^Fds, Gs^Fds, Gg, Dd, Dd, Dd^Dc, Dd, Wog^Xo, Dd, Dd^Dc, Dd, Dd, Gg, Gs^Fds, Gs^Fds, Gg, Ss, Gs^Fds, Ss, Wog, Wog^Xo, Wog^Xo
Wog^Xo, Wog^Xo, Wog, Gs^Fds, Gg, Gg, Gg, Gg, Ss, Ss, Mm, Dd, Dd, Dd, Wog^Xo, Dd, Dd, Dd, Mm, Ss, Ss, Gg, Gg, Gg, Gg, Gs^Fds, Wog, Wog^Xo, Wog^Xo
Wog^Xo, Wog^Xo, Wog, Gg^Tf, Gg^Tf, Gs^Fds, Gg, Ss, Mm, Mm, Wwf, Mm, Mm, Dd, Wog^Xo, Dd, Mm, Mm, Wwf, Mm, Mm, Ss, Gg, Gs^Fds, Gg^Tf, Gg^Tf, Wog, Wog^Xo, Wog^Xo
Wog^Xo, Wog, Wwg, Gg^Tf, Gg, Gs, Gs^Fds, Ss, Mm, Ww^Vm, Wwf, Wwf, Mm, Gd, Wog^Xo, Gd, Mm, Wwf, Wwf, Ww^Vm, Mm, Ss, Gs^Fds, Gs, Gg, Gg^Tf, Wwg, Wog, Wog^Xo
Wog^Xo, Wwg, Wwf, Wwf, Wwf, Gs, Gs, Gs^Fds, Wwg, Wwg, Mm, Mm, Gs^Fds, Gd, Wog^Xo, Gd, Gs^Fds, Mm, Mm, Wwg, Wwg, Gs^Fds, Gs, Gs, Wwf, Wwf, Wwf, Wwg, Wog^Xo
Wog^Xo, Wwg, Wwg, Wwf, Wwf, Wwf, Wwf, Gs, Wwg, Gs, Wwf, Wwf, Wwf, Gs, Wog^Xo, Gs, Wwf, Wwf, Wwf, Gs, Wwg, Gs, Wwf, Wwf, Wwf, Wwf, Wwg, Wwg, Wog^Xo
Wog^Xo, Wog, Wog, Gd^Fmf, Hhd^Vhh, Hhd^Fmf, Hhd^Fmf, Wwf, Wwf, Wwg, Wwg, Wwf, Wwf, Wwf, Wog^Xo, Wwf, Wwf, Wwf, Wwg, Wwg, Wwf, Wwf, Hhd^Fmf, Hhd^Fmf, Hhd^Vhh, Gd^Fmf, Wog, Wog, Wog^Xo
Wog^Xo, Wog^Xo, Wog, Gd, Hhd^Fmf, Hhd, Gd, Gd^Fmf, Wwf, Wwg, Wwg, Wwg, Ce, Wwf, Wog^Xo, Wwf, Ce, Wwg, Wwg, Wwg, Wwf, Gd^Fmf, Gd, Hhd, Hhd^Fmf, Gd, Wog, Wog^Xo, Wog^Xo
Wog^Xo, Wog^Xo, Wog, Gd, Gd, Gd, Wwg^Bw|, Wwf, Wwg, Wwf, Wwg, Wwg, Gs, Gd, Wog^Xo, Gd, Gs, Wwg, Wwg, Wwf, Wwg, Wwf, Wwg^Bw|, Gd, Gd, Gd, Wog, Wog^Xo, Wog^Xo
Wog^Xo, Wog^Xo, Wog, Gd, Gd, Wwg, Gd, Wwg, Gd, Wwg, Ww^Vm, Wwrg, Gll^Fmf, Gd, Wog^Xo, Gd, Gll^Fmf, Wwrg, Ww^Vm, Wwg, Gd, Wwg, Gd, Wwg, Gd, Gd, Wog, Wog^Xo, Wog^Xo
Wog^Xo, Wog^Xo, Xoa, Wwf, Wwf, Wwf, Hhd, Gd, Gd, Hhd, Hhd^Fmf, Gll^Fmf, Mm^Xm, Gs, Wog^Xo, Gs, Mm^Xm, Gll^Fmf, Hhd^Fmf, Hhd, Gd, Gd, Hhd, Wwf, Wwf, Wwf, Xoa, Wog^Xo, Wog^Xo
Wog^Xo, Xoa, Re, Re, Re, Gd, Xoa, Xoa, Re, Re, Re, Gll^Fmf, Gll^Fmf, Gll^Fmf, Wog^Xo, Gll^Fmf, Gll^Fmf, Gll^Fmf, Re, Re, Re, Xoa, Xoa, Gd, Re, Re, Re, Xoa, Wog^Xo
Wog^Xo, Xoa, Xoa, Re, Ce, Re, Xoa, Re, Ur, Re, Ur, Re, Gd^Vhr, Gll^Fmf, Wog^Xo, Gll^Fmf, Gd^Vhr, Re, Ur, Re, Ur, Re, Xoa, Re, Ce, Re, Xoa, Xoa, Wog^Xo
Wog^Xo, Wog^Xo, Xoa, Ce, Ce, Ke, Rd, Re, Uu, Uu, Uu^Tf, Re, Re, Re, Wog^Xo, Re, Re, Re, Uu^Tf, Uu, Uu, Re, Rd, Ke, Ce, Ce, Xoa, Wog^Xo, Wog^Xo
Wog^Xo, Wog^Xo, Wog^Xo, Xoa, Xoa, Xoa, Xoa, Re, Uu, Uu^Tf, Uh, Wog, Wog, Wog, Wog^Xo, Wog, Wog, Wog, Uh, Uu^Tf, Uu, Re, Xoa, Xoa, Xoa, Xoa, Wog^Xo, Wog^Xo, Wog^Xo
Wog^Xo, Wog^Xo, Wog^Xo, Wog^Xo, Wog^Xo, Wog^Xo, Wog, Uu, Wog, Uh, Wog, Wog, Wog^Xo, Wog^Xo, Wog^Xo, Wog^Xo, Wog^Xo, Wog, Wog, Uh, Wog, Uu, Wog, Wog^Xo, Wog^Xo, Wog^Xo, Wog^Xo, Wog^Xo, Wog^Xo
Wog^Xo, Wog^Xo, Wog^Xo, Wog^Xo, Wog^Xo, Wog^Xo, Wog^Xo, Wog, Wog^Xo, Wog, Wog^Xo, Wog^Xo, Wog^Xo, Wog^Xo, Wog^Xo, Wog^Xo, Wog^Xo, Wog^Xo, Wog^Xo, Wog, Wog^Xo, Wog, Wog^Xo, Wog^Xo, Wog^Xo, Wog^Xo, Wog^Xo, Wog^Xo, Wog^Xo
