Wo, Wo, Wo, Wo, Wo, Wo, Wo, Wo, Wo, Wo, Wo, Wo, Wo, Wo, Wo, Wo, Wo, Ds, Ds, Ds, Gs^Fp, Gg, Gg, Gg, Gg, Gg, Gs^Fp, Gs^Fp, Gs^Fp, Gg, Ds, Ds, Wo, Wo, Wo, Wo, Wo, Wo, Wo, Wo, Wo, Wo
Wo, Wo, Wo, Wo, Wo, Wo, Wo, Wo, Wo, Wo, Wo, Ww, Ww, Ww, Ww, Ww, Ww, Ds, Ds, Ss, Gs^Fp, Gg, Gg, Gg, Gg, Gg, Gs^Fp, Gs^Fp, Gs^Fp, Gs^Fp, Ds, Ds, Wo, Wo, Wo, Wo, Wo, Wo, Wo, Wo, Wo, Wo
Wo, Wo, Wo, Wo, Wo, Wo, Wo, Wo, Wo, Wo, Ww, Dd^Vda, Ds, Ds, Ds, Ds, Ds, Ds, Ds, Gs^Fp, Gs^Fp, Gg, Gg, Gg^Vh, Gg, Gg, Gs^Fp, Gs^Fp, Gs^Fp, Gs^Fp, Ds, Ds, Ww, Wo, Wo, Wo, Ww, Wo, Wo, Wo, Wo, Wo
Wo, Wo, Wo, Wo, Wo, Wo, Wo, Wo, Wo, Ww, Ds, Ds, Ds, Ds, Ds, Ds, Ds, Ds, Ss, Gs^Fp, Gs^Fp, Gg, Rr, Rr, Ch, Ch, Ch, Gs^Fp, Gs^Fp, Gs^Fp, Gg, Ds, Ds, Ds, Ds, Ds, Ds, Ww, Wo, Wo, Wo, Wo
Wo, Wo, Wo, Wo, Wo, Wo, Wo, Wo, Ww, Ds, Ds, Ds, Ds, Ds, Ss, Ss, Ss, Ss, Ss, Gs^Fp, Gs^Fp, Rr, Gg, Hh, Ch, 1 Kh, Gg, Gg, Gs^Fp, Gs^Fp, Gg, Gg, Gg, Ds, Ds, Ds, Ds, Ds, Ww, Wo, Wo, Wo
Wo, Wo, Wo, Wo, Wo, Wo, Wo, Wo, Ww, Ds, Ds, Ds, Ss, Gg, Gg, Gg, Gs^Fp, Gg, Gg, Gg, Gs^Fp, Rr, Hh, Hh, Hh, Hh, Gg, Gg, Gg, Gg, Gg, Gg, Gg, Gg, Gg, Gg, Ds, Ds, Dd^Vda, Ww, Wo, Wo
Wo, Wo, Wo, Wo, Wo, Wo, Wo, Wo, Ww, Ds, Ds, Ss, Gs^Fp, Gs^Fp, Gs^Fp, Gg, Gg^Ve, Gg, Gg, Gs^Fp, Gs^Fp, Rr, Hh, Hh, Hh, Hh, Gg, Gg, Gg, Gg, Gs^Fp, Gs^Fp, Gg, Gg, Gg, Gg, Gg, Ds, Ds, Ww, Wo, Wo
Wo, Wo, Wo, Wo, Ww, Ww, Ww, Ww, Ds, Ds, Ds, Gs^Fp, Gs^Fp, Gs^Fp, Gs^Fp, Gs^Fp, Gs^Fp, Gg, Gg, Gs^Fp, Gg, Rr, Hh, Hh, Hh, Hh, Hh, Hh, Gg, Gs^Fp, Gs^Fp, Gg^Ve, Gs^Fp, Gg, Aa, Aa, Aa, Gg, Ds, Ds, Wo, Wo
Wo, Wo, Wo, Ww, Ds, Dd^Vda, Ds, Ds, Ds, Ds, Ds, Gg^Vh, Gg, Gs^Fp, Gs^Fp, Gs^Fp, Gs^Fp, Gs^Fp, Gs^Fp, Gs^Fp, Gg, Rr, Gg, Gg, Gg, Hh, Gg, Hh, Hh, Hh, Hh, Gs^Fp, Gg, Gg, Aa, Aa, Aa, Gg, Ds, Ds, Wo, Wo
Wo, Wo, Ww, Ds, Ds, Ds, Ds, Ds, Ds, Ds, Ds, Gg, Gg, Gg, Gs^Fp, Gs^Fp, Gg^Ve, Gs^Fp, Gs^Fp, Gs^Fp, Rr, Rr, Gg^Ve, Gs^Fp, Gg, Gg, Gg, Hh, Hh, Hh, Hh, Hh, Hh, Gg, Aa, Aa, Aa, Gg, Ds, Ds, Ww, Wo
Wo, Ww, Ds, Ds, Ds, Ds, Ds, Ds, Ds, Ds, Ds, Gs^Fp, Gg, Gs^Fp, Gs^Fp, Gs^Fp, Gs^Fp, Gs^Fp, Gs^Fp, Gs^Fp, Rr, Gs^Fp, Gs^Fp, Gs^Fp, Gg, Gg, Gg, Hh, Hh, Hh, Hh, Hh, Hh, Hh, Aa, Aa, Aa, Aa, Gg, Ds, Ww, Ww
Wo, Ds, Ds, Ds, Ds, Ds, Ds, Ds, Ds, Gg, Gg, Gs^Fp, Gg, Gs^Fp, Gs^Fp, Gg, Gg, Gg, Gg, Gg, Rr, Gs^Fp, Gs^Fp, Gs^Fp, Gg, Gg, Gg, Hh, Hh, Hh, Mm, Mm, Ha, Ha, Gg, Gg, Gg, Aa, Gg, Ds, Ds, Ds
Ww, Ds, Ds, Ds, Ds, Gs^Fp, Gs^Fp, Gg, Gg, Gg, Gg, Gg, Gg, Gs^Fp, Gs^Fp, Gs^Fp, Gg, Gg, Gg, Gg, Gs^Fp, Rr, Rr, Gg, Gg, Gg, Gg, Hh, Hh, Mm, Mm, Mm, Hh, Hh, Gg, Gg^Vh, Gg, Gg, Aa, Ds, Ds, Ds
Ds, Ds, Ds, Ds, Gs^Fp, Ss, Gg^Ve, Gs^Fp, Gg, Gg, Gg, Gg, Gg, Gs^Fp, Gs^Fp, Gg, Gg, Gg, Gg, Ss, Gs^Fp, Gs^Fp, Rr, Gs^Fp, Gs^Fp, Gs^Fp, Gs^Fp, Hh, Mm, Mm, Mm, Mm, Hh, Hh^Vhh, Hh, Gs^Fp, Gg, Gg, Aa, Ds, Ds, Ds
Ds, Ds, Gs^Fp, Gs^Fp, Gs^Fp, Ss, Gs^Fp, Gs^Fp, Gg, Gg, Gg, Gg, Gg, Gs^Fp, Gs^Fp, Gg, Gg, Ss, Ss, Gs^Fp, Gs^Fp, Rr, Gg, Gs^Fp, Gg^Ve, Gs^Fp, Gs^Fp, Hh, Mm, Mm, Mm, Mm, Hh, Hh, Hh, Gs^Fp, Gg, Gg, Gg, Aa, Ds, Ds
Ds, Ds, Gs^Fp, Ch, Ch, Ch, Gs^Fp, Gg, Gg, Gg, Aa, Gg, Gg, Gg^Ve, Gs^Fp, Gs^Fp, Gs^Fp, Gs^Fp, Gs^Fp, Gg, Rr, Rr, Gg, Gs^Fp, Gs^Fp, Gs^Fp, Hh, Hh, Mm, Mm, Mm, Mm, Mm, Hh, Hh, Gs^Fp, Gs^Fp, Gg, Gg, Aa, Ds, Aa
Ds, Gs^Fp, Gs^Fp, Ch, 3 Kh, Gs^Fp, Gg, Gg, Gg, Aa, Aa, Aa, Gg, Gs^Fp, Gs^Fp, Gs^Fp, Gs^Fp, Gs^Fp, Gg, Gg, Rr, Gg, Gg, Gg, Gs^Fp, Gs^Fp, Gs^Fp, Hh, Mm, Mm, Mm, Mm, Mm, Mm, Mm, Hh, Gs^Fp, Gg, Gg, Aa, Aa, Aa
Gs^Fp, Ss, Gg^Ve, Rr, Gs^Fp, Gs^Fp, Hh, Hh, Hh, Hh, Aa, Aa, Gg, Gg, Gs^Fp, Gs^Fp, Gs^Fp, Gg, Gg, Gg, Rr, Gg, Gg, Gg, Gg, Gs^Fp, Gg, Hh, Mm, Mm, Mm, Mm, Mm, Mm, Mm, Mm, Hh, Gg, Aa, Aa, Aa, Aa
Gg, Gs^Fp, Gs^Fp, Rr, Gg, Hh, Mm, Mm, Mm, Mm, Mm, Hh, Hh, Gg, Gg, Gg, Gg, Gg, Gs^Fp, Gs^Fp, Gs^Fp, Rr, Rr, Gg, Gs^Fp, Gs^Fp, Gs^Fp, Hh, Mm, Mm, Mm, Mm, Mm, Mm, Mm, Mm, Hh, Gg, Gg, Gg, Gg, Ds
Gg, Gg, Gg, Rr, Hh, Mm, Mm, Mm, Mm, Mm, Mm, Mm, Hh, Gs^Fp, Gs^Fp, Gs^Fp, Gs^Fp, Gs^Fp, Gs^Fp, Gs^Fp, Gs^Fp, Gg, Rr, Gg, Gs^Fp, Gs^Fp, Gs^Fp, Gs^Fp, Hh, Mm, Mm, Mm, Mm, Mm, Mm, Mm, Hh, Gg, Gg, Gg, Gg, Gg
Gg, Gg, Gg, Rr, Hh, Mm, Mm, Mm, Mm, Mm, Mm, Mm, Hh, Gs^Fp, Gs^Fp, Gg^Ve, Gs^Fp, Gs^Fp, Gs^Fp, Gs^Fp, Gs^Fp, Gs^Fp, Gs^Fp, Rr, Gg, Gs^Fp, Gs^Fp, Hh, Mm, Mm, Mm, Mm, Mm, Mm, Mm, Mm, Hh, Gg, Gg, Gg, Gg, Gg
Gg, Gg, Gg, Rr, Hh, Mm, Mm, Mm, Mm, Mm, Mm, Mm, Mm, Gs^Fp, Gs^Fp, Gs^Fp, Gs^Fp, Gs^Fp, Gs^Fp, Gs^Fp, Gs^Fp, Gs^Fp, Gs^Fp, Rr, Gs^Fp, Gs^Fp, Gg^Ve, Gs^Fp, Mm, Mm, Mm, Mm, Mm, Ww, Mm^Vhh, Ww, Mm, Gs^Fp, Gg^Ve, Gs^Fp, Gg, Ds
Gg, Gg, Gg, Rr, Hh, Mm, Mm, Mm, Mm, Mm, Mm, Mm, Mm, Gg, Gg, Gs^Fp, Gs^Fp, Gs^Fp, Gs^Fp, Gs^Fp, Gs^Fp, Ss, Gs^Fp, Rr, Gs^Fp, Gs^Fp, Gs^Fp, Gs^Fp, Mm, Mm, Mm, Mm, Mm, Ww, Mm, Ww, Hh, Gg, Gs^Fp, Gg, Gg, Ds
Gg, Gg, Gg, Rr, Hh, Hh, Mm, Mm, Mm, Mm, Mm, Mm, Hh, Gg, Gg, Gg, Gg^Ve, Gs^Fp, Gg, Ss, Ss, Ss, Ss, Rr, Rr, Gg, Gg, Gg, Mm, Mm, Mm, Mm, Mm, Ww, Ww, Ww, Ww, Gs^Fp, Gs^Fp, Gg, Gg, Ds
Gs^Fp, Gg, Gg, Rr, Rr, Gg, Hh, Hh, Mm, Hh, Hh, Hh, Gs^Fp, Gg, Gg, Gg, Gg, Gs^Fp, Ss, Ss, Ss, Ss, Ss, Gg, Gg, Rr, Gg, Gg, Hh, Mm, Mm, Ww, Ww, Ww, Ww, Ww, Ww, Ww, Ww, Gs^Fp, Ds, Ds
Gs^Fp, Gg^Ve, Gg, Gg, Gg, Rr, Rr, Hh, Gg, Gg, Gg, Gg^Vh, Gg, Gg, Gg, Gg, Gg, Gs^Fp, Ss, Ss, Gg, Gg, Ss, Gs^Fp, Gg, Rr, Gg, Gg, Hh, Hh, Mm, Mm, Ww, Mm, Ww, Ww, Ww, Gg^Vh, Gg, Ww, Ds, Ds
Ds, Gs^Fp, Gs^Fp, Gg, Gg, Gg, Gg, Rr, Rr, Gg, Gg, Gg, Gg, Gg, Gg, Gg, Gg, Gs^Fp, Gs^Fp, Ss, Gg, Ss, Ss, Gg, Gg, Rr, Gg, Gg, Gg, Gg, Hh, Hh, Hh, Hh, Ww, Ww, Ww, Gg, Gg, Ww, Ww, Ww
Ds, Ds, Gs^Fp, Gs^Fp, Gs^Fp, Gg, Gg, Aa, Aa, Rr, Rr, Rr, Rr, Gg, Gg, Gg, Gg, Gg, Gs^Fp, Ss, Ss, Ss, Gs^Fp, Gg, Gg, Rr, Gg, Gg, Gg, Gg, Gg^Ve, Gs^Fp, Gs^Fp, Gs^Fp, Rr, Ch, Ch, Ch, Gg, Gs^Fp, Ds, Ww
Ww, Ww, Ds, Ds, Ds, Ds, Ds, Aa, Gg, Gg, Gg, Gg^Vh, Rr, Aa, Aa, Aa, Gg, Gg, Gg, Gs^Fp, Gs^Fp, Gs^Fp, Rr, Gg^Vh, Rr, Rr, Rr, Rr, Rr, Gs^Fp, Gs^Fp, Gs^Fp, Rr, Rr, Gs^Fp, Ch, 4 Kh, Gg, Gg, Ds, Ds, Ww
Wo, Wo, Wo, Wo, Ww, Ds, Ds, Ds, Gg, Gg, Gg, Gg, Gg, Rr, Rr, Gg, Gg, Gg, Gg, Gg, Rr, Rr, Gg, Rr, Aa, Rr, Gg, Gs^Fp, Gg, Rr, Rr, Rr, Gs^Fp, Gs^Fp, Gs^Fp, Gs^Fp, Gg, Gg, Ds, Ds, Ds, Wo
Wo, Wo, Wo, Wo, Wo, Wo, Ds, Ds, Ds, Gg, Gs^Fp, Gs^Fp, Gs^Fp, Gg, Rr, Gg, Gg, Gg, Rr, Rr, Gg, Gg, Gg, Aa, Aa, Rr, Gg, Gs^Fp, Gs^Fp, Gs^Fp, Gs^Fp, Gs^Fp, Gs^Fp, Gs^Fp, Gs^Fp, Gs^Fp, Ds, Ds, Ds, Ds, Ds, Wo
Wo, Wo, Wo, Wo, Wo, Wo, Wo, Ww, Ds, Ds, Ds, Ds, Gs^Fp, Gs^Fp, Rr, Ch, Ch, Ch, Aa, Aa, Aa, Aa, Aa, Rr, Gg, Gg, Gs^Fp, Gs^Fp, Gs^Fp, Gs^Fp, Ds, Ds, Ds, Ds, Ds, Ds, Ds, Ds, Ds, Ds, Ww, Wo
Wo, Wo, Wo, Wo, Wo, Wo, Wo, Wo, Ww, Ds, Ds, Ds, Ds, Ds, Rr, Ch, 2 Kh, Gg, Rr, Rr, Gg, Rr, Gg, Gg, Gg, Gg, Gs^Fp, Gs^Fp, Ds, Ds, Ww, Ww, Ww^Vm, Ww, Ww, Ww, Wo, Ww, Wo, Ww, Wo, Wo
Wo, Wo, Wo, Wo, Wo, Wo, Wo, Wo, Ww, Ds, Ds, Ds, Ds, Ds, Rr, Gs^Fp, Gg^Vh, Gg, Rr, Gg, Gg, Gg, Gg, Gg, Gg, Gg, Gg, Ds, Ds, Ds, Wo, Wo, Wo, Wo, Wo, Wo, Wo, Wo, Wo, Wo, Wo, Wo
Wo, Wo, Wo, Wo, Wo, Wo, Wo, Wo, Ww, Ds, Ds, Ds, Ds, Ds, Gs^Fp, Rr, Rr, Rr, Gg, Gg, Gg, Gg, Gg, Gg, Gg, Gg, Ds, Ds, Ds, Ww, Wo, Wo, Wo, Wo, Wo, Wo, Wo, Wo, Wo, Wo, Wo, Wo
Wo, Wo, Wo, Wo, Wo, Wo, Wo, Wo, Ww, Ds, Ds, Ds, Ds, Ds, Gs^Fp, Gg, Gg, Gg, Gs^Fp, Gs^Fp, Gg, Gg, Gg, Gg, Gg, Ds, Ds, Ds, Ds, Ww, Wo, Wo, Wo, Wo, Wo, Wo, Wo, Wo, Wo, Wo, Wo, Wo
Wo, Wo, Wo, Wo, Wo, Wo, Wo, Wo, Ww, Dd^Vda, Ds, Ds, Ds, Ds, Ds, Ds, Gg, Gs^Fp, Gs^Fp, Gs^Fp, Gg, Gg, Gg, Aa, Aa, Aa, Aa, Aa, Ds, Wo, Wo, Wo, Wo, Wo, Wo, Wo, Wo, Wo, Wo, Wo, Wo, Wo
Wo, Wo, Wo, Wo, Wo, Wo, Wo, Wo, Ww, Ww, Ds, Ds, Ds, Ds, Ds, Ds, Ds, Gs^Fp, Gs^Fp, Gg, Gg, Gg, Gg, Ds, Ds, Ds, Ds, Ds, Ww, Ww, Wo, Wo, Wo, Wo, Wo, Wo, Wo, Wo, Wo, Wo, Wo, Wo
