Ww, Ds, Ds, Aa, Aa, Gg, Gg, Gg, Gg, Gg, Gg, Aa, Gg, Gs^Fp, Gs^Fp, Gs^Fp, Gs^Fp, Gs^Fp, Gg, Gs^Fp, Gs^Fp, Gg, Gg, Gg, Gg, Gs^Fp, Gg, Gg, Gg, Gg, Gg, Gs^Fp, Gg, Gs^Fp, Gs^Fp, Gs^Fp, Gs^Fp, Gs^Fp
Ds, Ds, Aa, Gg, Aa, Gg, Gg, Gg, Gg, Gg, Aa, Aa, Gg, Gg, Gg, Gs^Fp, Gs^Fp, Gs^Fp, Gg, Gg, Gs^Fp, Gg, Gg, Gg, Gg, Gg, Gg, Gg, Gg, Gg, Gs^Fp, Gs^Fp, Gs^Fp, Gg, Gg, Gg, Gs^Fp, Gs^Fp
Ds, Aa, Aa, Aa, Aa, Aa, Aa, Gg, Gg, Gg, Gg, Gg, Gg, Gg, Gg, Gs^Fp, Gs^Fp, Gs^Fp, Gg, Gg, Gg, Gg, Gg, Gg, Gg, Gg, Gg, Gg, Gg, Gs^Fp, Gs^Fp, Gs^Fp, Gg, Gg, Gg, Gg, Gs^Fp, Gs^Fp
Ds, Ds, Aa, Aa, Aa, Aa, Aa, Gg, Gg, Gg, Gg, Gs^Fp, Gs^Fp, Gs^Fp, Gg, Gs^Fp, Gg^Ve, Gs^Fp, Gg, Gg, Gg, Gg, Gg, Gg, Gg, Aa, Gg, Gg, Gg, Gs^Fp, Ch, Ch, Ch, Gg, Gg, Gs^Fp, Gs^Fp, Gs^Fp
Ds, Ds, Aa, Aa, Aa, Aa, Gg, Gg, Gg, Gg, Gs^Fp, Gs^Fp, Gs^Fp, Gs^Fp, Gg, Gs^Fp, Gs^Fp, Gs^Fp, Gg, Gg, Gg, Gg, Gg, Gg, Gg, Aa, Gg, Gg, Gg, Gs^Fp, Ch, 1 Kh, Gg, Gg, Gg, Gg, Gs^Fp, Gs^Fp
Ds, Ds, Ds, Gg, Ch, Ch, Ch, Gg, Gg, Gs^Fp, Gg, Gs^Fp, Gs^Fp, Gg, Gg, Gg, Gs^Fp, Gs^Fp, Gs^Fp, Gg, Gg, Gg, Gg, Gg, Gg, Aa, Gg, Gg, Gg, Gg, Rr, Rr, Gg, Aa, Aa, Gg, Gg, Gs^Fp
Ds, Ds, Ds, Gg, Ch, 3 Kh, Rr, Gg, Gg, Gs^Fp, Gg, Gs^Fp, Gs^Fp, Gg, Gg, Gg, Gg, Gs^Fp, Gg, Gg, Gg, Gg, Gg, Gg, Gg, Gg, Gg, Gg, Gg^Vh, Rr, Gg, Gg, Gg, Aa, Aa, Gg, Gg, Gs^Fp
Ds, Ds, Ds, Ds, Gg, Gg, Rr, Aa, Gg, Gg, Gg, Gg, Gs^Fp, Gs^Fp, Gs^Fp, Gs^Fp, Gs^Fp, Gs^Fp, Gg, Gg, Gg, Gg, Gg, Gg, Gg, Gg, Gg, Gg, Rr, Rr, Gg, Gg, Gg, Gg, Gg, Gg, Gg, Gs^Fp
Ds, Ds, Ds, Ds, Gg, Gg, Rr, Aa, Gg^Vh, Gg, Gg, Gg, Gs^Fp, Gg, Gs^Fp, Gs^Fp, Gs^Fp, Gs^Fp, Gg, Gg, Gg, Gg, Gg, Gg, Gg, Gg, Gg, Gg, Rr, Gg, Gg, Gg, Gg, Gg, Gg^Vh, Gg, Gg, Gs^Fp
Ds, Ds, Ds, Ds, Gg, Gg, Gg, Rr, Rr, Gg, Gg, Gg, Gs^Fp, Gs^Fp, Gs^Fp, Gg, Gs^Fp, Gg, Gg, Gg, Gg, Gg, Gg, Gg, Aa, Aa, Gg, Gg, Rr, Gg, Gg, Gg, Gg, Gg, Gg, Gg, Gg, Gg
Ds, Ds, Ds, Ds, Ds, Gg, Gg, Gg, Gg, Rr, Rr, Gs^Fp, Ss, Gs^Fp, Gg, Gg, Gs^Fp, Gs^Fp, Gg, Gg, Gg^Vh, Gg, Gg, Gg, Aa, Aa, Gg, Gg, Rr, Gg, Gg, Gg, Gg, Gg, Gg, Aa, Aa, Aa
Ds, Ds, Ds, Ds, Aa, Gg, Gg, Gg, Gg, Gs^Fp, Gs^Fp, Rr, Rr, Gg, Gs^Fp, Gg, Gg, Gs^Fp, Gg, Gg, Gg, Gg, Gg, Aa, Aa, Aa, Aa, Aa, Aa, Gg, Gg, Gg, Gg, Gg, Gg, Aa, Aa, Aa
Ww, Ds, Ds, Ds, Aa, Aa, Aa, Gg, Gg, Gs^Fp, Gg^Ve, Gs^Fp, Rr, Gs^Fp, Gg^Ve, Gs^Fp, Gs^Fp, Gs^Fp, Gg, Gg, Gg, Aa, Aa, Aa, Aa, Aa, Aa, Aa, Aa, Aa, Aa, Aa, Aa, Aa, Gg, Aa, Gg, Gg
Ww, Ds, Ds, Ds, Aa, Aa, Aa, Aa, Gg, Gg, Gg, Gs^Fp, Gs^Fp, Rr, Gs^Fp, Gs^Fp, Gs^Fp, Gg, Gg, Gg, Gg, Aa, Aa, Aa, Aa, Aa, Aa, Aa, Aa, Aa, Aa, Gg, Aa, Aa, Gg, Gg, Gg, Gg
Ww, Ds, Ds, Gg, Aa, Aa, Aa, Aa, Gg, Gg, Gg, Gg, Gg, Rr, Rr, Gg, Gs^Fp, Gg, Rr, Gg, Gg, Gg, Gg, Gg, Rr, Gg, Rr, Rr, Rr, Aa, Rr, Gg, Gg, Gg, Gg, Gg, Gs^Fp, Gs^Fp
Ww, Ds, Gg, Aa, Aa, Aa, Aa, Aa, Aa, Gg, Gg, Gg, Gg, Gg, Gg, Rr, Rr, Rr, Gg, Rr, Rr, Gg, Gg, Rr, Gg, Rr, Rr, Gg^Vh, Rr, Gg, Rr, Gg, Gg, Gg, Gg, Gs^Fp, Gg, Gg
Ds, Ds, Gg, Aa, Aa, Aa, Gg, Gg, Gg, Gg, Gg, Gg, Gs^Fp, Gg, Gg, Gg, Gg, Gg, Gg, Gg, Gg, Rr, Rr, Rr, Rr, Rr, Gg, Rr, Gg, Gg, Rr, Aa, Gg, Gg, Gg, Gs^Fp, Gg^Ve, Gg
Ds, Gg, Gg, Aa, Aa, Gg, Gg^Vh, Gs^Fp, Gs^Fp, Gg, Gg, Gg, Gg^Ve, Gs^Fp, Gg, Gg, Gg, Gg, Gg, Gg, Gg, Gg^Vh, Rr, Rr, Gg, Gg, Gs^Fp, Gg, Gg, Gg, Rr, Aa, Aa, Aa, Gg, Gg, Gs^Fp, Gs^Fp
Gs^Fp, Gg, Gg, Aa, Aa, Gg, Hh, Hh, Hh, Hh, Hh, Gs^Fp, Gs^Fp, Gs^Fp, Gs^Fp, Gg, Gg, Gg, Gg, Gg, Rr, Rr, Gg, Gg, Gg, Gg, Gg, Gg, Gg, Gg, Gg, Aa, Aa, Aa, Aa, Gg, Gg, Gs^Fp
Gs^Fp, Gs^Fp, Gg, Gg, Gg, Hh, Hh, Mm, Mm, Mm, Hh, Hh, Gs^Fp, Gg, Gg, Gg, Gg, Gg, Rr, Rr, Gg, Aa, Aa, Hh, Hh, Hh, Gg, Gg, Aa, Aa, Aa, Aa, Aa, Aa, Aa, Gg, Gg, Gg
Ss, Gg^Ve, Gg, Gg, Gg, Hh, Mm, Mm, Mm, Mm, Hh, Hh, Hh, Gg, Gg, Gg, Rr, Rr, Gg, Hh, Gg, Hh, Hh, Hh, Hh, Mm, Ha, Aa, Aa, Aa, Aa, Aa, Aa, Gg, Gg, Gg, Gg, Gg
Gs^Fp, Gs^Fp, Gg, Gg, Gg, Hh, Mm, Mm, Mm, Mm, Mm, Hh, Hh, Gg, Rr, Rr, Gs^Fp, Gs^Fp, Hh, Hh, Hh, Hh, Mm, Mm, Mm, Mm, Mm, Ha, Gg, Gg, Gg, Gg, Rr, Gg, Gg, Gg, Gg, Gg
Gg, Gg, Gg, Gg, Gg, Hh, Mm, Mm, Mm, Mm, Mm, Hh, Hh, Hh, Rr, Gg, Gg, Hh, Hh^Vhh, Hh, Hh, Mm, Mm, Mm, Mm, Mm, Mm, Hh, Gg^Vh, Gg, Gg, Gg, Rr, Gg, Gg, Gg, Gg, Gg
Gg, Gg, Gg, Gg, Gg, Gg, Hh, Hh, Hh, Mm, Mm, Hh, Hh, Hh, Aa, Rr, Hh, Hh, Hh, Hh, Mm, Mm, Mm, Mm, Mm, Mm, Mm, Hh, Gg, Gg, Gg, Gg, Rr, Gg, Gg, Gg, Gg, Gg
Aa, Aa, Aa, Gg, Gg, Aa, Aa, Hh, Hh, Hh, Hh, Hh, Hh, Hh, Aa, Rr, Hh, Gs^Fp, Hh, Hh, Hh, Mm, Mm, Mm, Mm, Mm, Mm, Hh, Gg, Gs^Fp, Gg, Gs^Fp, Rr, Gg, Gg, Gg, Gs^Fp, Gs^Fp
Aa, Aa, Aa, Gg, Gg, Gg, Gg, Gg, Gg, Gg, Gg, Gg, Gg^Vh, Gg, Aa, Aa, Gg, Gg, Gs^Fp, Hh, Hh, Hh, Mm, Mm, Mm, Mm, Mm, Hh, Gs^Fp, Gs^Fp, Gg, Gg, Rr, Gg, Gg, Gg, Gs^Fp, Gs^Fp
Aa, Aa, Gg, Gg, Gg, Gg, Gg, Gg, Gg^Ve, Gs^Fp, Gs^Fp, Gg, Gg, Gg, Rr, Aa, Gg, Gg, Gg, Gs^Fp, Hh, Hh, Hh, Hh, Hh, Hh, Hh, Hh, Gg, Gg, Gg, Gg, Gg, Rr, Gg, Gg, Gs^Fp, Gg
Ds, Ds, Gg^Vh, Gg, Gg, Gg, Gg, Gg, Gs^Fp, Gs^Fp, Gs^Fp, Gg, Gg, Gg, Aa, Aa, Aa, Gg, Gg, Gs^Fp, Hh, Hh, Hh, Hh, Hh, Hh, Gg^Vh, Gg, Gg, Gg, Gg, Gg, Gg, Rr, Gg, Gg, Gs^Fp, Gg
Ds, Ds, Ds, Gs^Fp, Gg, Gg, Gg, Gg, Gs^Fp, Gs^Fp, Gs^Fp, Gg, Gg, Gg, Rr, Aa, Aa, Aa, Gg, Gs^Fp, Gs^Fp, Gg, Gs^Fp, Gg, Gg, Gg, Gg, Gg, Gg, Gg, Gg, Gg, Gg, Rr, Gg, Gs^Fp, Gg, Gg
Ww, Ds, Ds, Ds, Ds, Ds, Gg, Gg, Gg, Gs^Fp, Gg, Gg, Gg, Gg, Rr, Aa, Aa, Aa, Gg, Gs^Fp, Gg^Ve, Gs^Fp, Gs^Fp, Gg, Gg, Gg, Aa, Aa, Aa, Gg, Gg, Gg, Gg, Rr, Gg, Gs^Fp, Ss, Gg
Wo, Ww, Ww, Ds, Ds, Ds, Ds, Ds, Gs^Fp, Gs^Fp, Gg, Gg, Gg, Gg, Rr, Gg, Aa, Aa, Gg, Gs^Fp, Gs^Fp, Gs^Fp, Gs^Fp, Gg, Gg, Gg, Aa, Gg, Gg, Gg, Gg, Gg, Aa, Rr, Gg, Gs^Fp, Gg^Ve, Gs^Fp
Wo, Wo, Ww, Ww, Ww, Ww, Ww, Ds, Ds, Gs^Fp, Gg, Gg, Gg, Ch, Ch, Ch, Aa, Aa, Gg, Gg, Gs^Fp, Gs^Fp, Gs^Fp, Gs^Fp, Gg, Gg, Gg, Gg, Gg, Gg, Gg, Ch, Ch, Ch, Gg, Gs^Fp, Gs^Fp, Gs^Fp
Wo, Wo, Wo, Wo, Wo, Wo, Wo, Ww, Ds, Gs^Fp, Gg, Aa, Gg, Ch, 2 Kh, Rr, Gg, Gg, Gg, Gg, Gg, Gs^Fp, Gs^Fp, Gs^Fp, Gg, Gg^Vh, Gg, Gg, Gg, Gg, Gg, Ch, 4 Kh, Rr, Gg, Gs^Fp, Gs^Fp, Gs^Fp
Wo, Wo, Wo, Wo, Wo, Wo, Wo, Wo, Ww, Dd^Vda, Gg, Gg, Gg, Gg, Gg, Gg, Gg, Gg, Gg, Gg, Gg, Gg, Gg, Gg, Gg, Gg, Gg, Gg, Gg, Gg, Gg, Gg, Gg, Gg, Gs^Fp, Gs^Fp, Gs^Fp, Ss
Wo, Wo, Wo, Wo, Wo, Wo, Wo, Wo, Wo, Ww, Ds, Gg, Gg, Gg^Vh, Gg, Gg, Gg, Gg, Gg, Gg, Gg, Gg, Gg, Gg, Gg, Gg, Gg, Gg, Gg, Gg, Gg, Gg, Gg, Gg, Gs^Fp, Gg^Ve, Ss, Ss
Wo, Wo, Wo, Wo, Wo, Wo, Wo, Wo, Wo, Wo, Ds, Gg, Gs^Fp, Gs^Fp, Gs^Fp, Gg, Gg, Aa, Aa, Gg, Gg, Gg, Gg, Gg, Gg, Gg, Gg, Gg, Aa, Aa, Aa, Aa, Aa, Gg, Gs^Fp, Gs^Fp, Ss, Ss
Wo, Wo, Wo, Wo, Wo, Wo, Wo, Wo, Wo, Wo, Ds, Gs^Fp, Gs^Fp, Gg^Ve, Gs^Fp, Gg, Gg, Aa, Aa, Gg, Gg, Gg, Gg, Gg, Gg, Gg, Gg, Gg, Gg, Aa, Aa, Aa, Aa, Gg, Gg, Gs^Fp, Ss, Gs^Fp
Wo, Wo, Wo, Wo, Wo, Wo, Wo, Wo, Wo, Wo, Ww, Ds, Gs^Fp, Gs^Fp, Gs^Fp, Gg, Gg, Aa, Aa, Gg, Gg, Gg, Gg, Gg, Gs^Fp, Gg, Hh, Gs^Fp, Gg, Gg, Gg, Gg, Aa, Gg, Gg, Gs^Fp, Gs^Fp, Gs^Fp
