Ai, Ds, Ai, Aa, Aa, Gg, Gg, Gg, Gg, Gg, Gg, Aa, Gg, Gs^Fp, Gs^Fp, Gs^Fp, Gs^Fp, Gs^Fp, Gg, Gs^Fp, Gs^Fp, Gg, Gg, Gg, Gg, Gs^Fp, Gg, Gg, Gg, Gg, Gg, Gs^Fp, Gg, Gs^Fp, Gs^Fp, Gs^Fp, Gs^Fp, Gs^Fp
Ai, Ai, Ai, Ai, Aa, Gg, Gg, Gg, Gg, Gg, Aa, Aa, Gg, Gg, Gg, Gs^Fp, Gs^Fp, Gs^Fp, Gg, Gg, Gs^Fp, Gg, Gg, Gg, Gg, Gg, Gg, Gg, Gg, Gg, Gs^Fp, Gs^Fp, Gs^Fp, Gg, Gg, Gg, Gs^Fp, Gs^Fp
Ai, Ai, Aa, Aa, Aa, Aa, Aa, Gg, Gg, Gg, Gg, Gg, Gg, Gg, Gg, Gs^Fp, Gs^Fp, Gs^Fp, Gg, Gg, Gg, Gg, Gg, Gg, Gg, Gg, Gg, Gg, Gg, Gs^Fp, Gs^Fp, Gs^Fp, Gg, Gg, Gg, Gg, Gs^Fp, Gs^Fp
Ai, Ai, Aa, Aa, Aa, Aa, Aa, Gg, Gg, Gg, Gg, Gs^Fp, Gs^Fp, Gs^Fp, Gg, Gs^Fp, Gg^Ve, Gs^Fp, Gg, Gg, Gg, Gg, Ss, Gg, Gg, Aa, Gg, Gg, Gg, Gs^Fp, Ch, Ch, Ch, Gg, Gg, Gs^Fp, Gs^Fp, Gs^Fp
Rrd, Rrd, Rrd, Aa, Aa, Aa, Gg, Gg, Gg, Gg, Gs^Fp, Gs^Fp, Gs^Fp, Gs^Fp, Gg, Gs^Fp, Gs^Fp, Gs^Fp, Ss, Gg, Ss, Gg, Ss, Gg, Gg, Aa, Gg, Gg, Gg, Gs^Fp, Ch, 1 Kh, Gg, Gg, Gg, Gg, Gs^Fp, Gs^Fp
Rrd, Dd^Dc, Rd, Rd, Ch, Ch, Ch, Gg, Gg, Gs^Fp, Gd, Gs^Fp, Gs^Fp, Gg, Gg, Gg, Gs^Fp, Gs^Fp, Gs^Fp, Ss, Ss, Ss, Ss, Gg, Gg, Aa, Gg, Gg, Gg, Gg, Rr, Rr, Gg, Aa, Aa, Gg, Gg, Gs^Fp
Rb, Rd, Re, Rd, Ch, 3 Kh, Rr, Gg, Gg, Gs^Fp, Gg, Gs^Fp, Gs^Fp, Gg, Gg, Gg, Gd, Gs^Fp, Gg, Gd, Ss, Ss, Gg, Gg, Gg, Gg, Gg, Gg, Gg^Vh, Rr, Gg, Gg, Gg, Aa, Aa, Gg, Gg, Gs^Fp
Re, Rd, Re, Rd, Gg, Gg, Rr, Aa, Gg, Gg, Gg, Gll, Gs^Fp, Gs^Fp, Gs^Fp, Gs^Fp, Gs^Fp, Gs^Fp, Gg, Gg, Gg, Ss, Gg, Gg, Wwrg, Gg, Wwg, Gg, Rr, Rr, Gs, Gg, Gs, Gg, Gg, Gg, Gll, Gs^Fp
Rb, Rb, Rb, Rb, Gg, Gg, Rr, Aa, Gg^Vh, Gg, Gll, Gll, Gs^Fp, Gd, Gs^Fp, Gs^Fp, Gs^Fp, Gs^Fp, Gs, Gg, Gs, Gg, Gg, Wwg, Wwg, Wwg, Ai, Gg, Rr, Gg, Gs, Gs, Gs, Gg, Gg^Vh, Gg, Gll, Gs^Fp
Sm, Sm, Sm, Rb, Gs, Gg, Gg, Rr, Rr, Gg, Gg, Gll, Gs^Fp, Gs^Fp, Gs^Fp, Gd, Gs^Fp, Gll, Gg, Gs, Gg, Gg, Wwg, Wwg, Aa, Aa, Ai, Gg, Rr, Gg, Gg, Gs, Gs, Gg, Gg, Gg, Gg, Gg
Sm, Sm, Sm, Ds, Ds, Gs, Gs, Gg, Gg, Rr, Rr, Gs^Fp, Ss, Gs^Fp, Gs, Gs, Gs^Fp, Gs^Fp, Gg, Gg, Gg^Vh, Gg, Gg, Wwg, Aa, Aa, Gg, Gg, Rr, Gg, Gg, Gs, Gg, Gg, Gg, Aa, Aa, Aa
Sm, Sm, Sm, Ds, Aa, Gg, Gg, Gg, Gg, Gs^Fp, Gs^Fp, Rr, Rr, Gg, Gs^Fp, Gg, Gd, Gs^Fp, Gll, Gg, Gg, Gg, Gg, Aa, Aa^Fma, Aa, Aa, Aa, Aa, Gg, Gg, Gg, Gg, Gg, Gg, Aa, Aa, Aa
Sm, Sm, Ds, Ds, Aa, Aa, Aa, Gg, Gg, Gs^Fp, Gg^Ve, Gs^Fp, Rr, Gs^Fp, Gg^Ve, Gs^Fp, Gs^Fp, Gs^Fp, Gll, Gg, Gg, Aa, Aa, Aa, Aa^Fma, Aa^Fma, Aa, Aa, Aa, Aa, Aa, Aa, Aa, Aa, Gg, Aa, Gs, Gg
Sm, Ds, Ds, Ds, Aa, Aa, Aa^Fma, Aa, Gg, Gg, Gg, Gs^Fp, Gs^Fp, Rr, Gs^Fp, Gs^Fp, Gs^Fp, Gg, Gg, Gg, Gg, Aa, Aa, Aa, Aa, Aa, Aa, Aa, Aa, Aa, Aa, Gg, Aa, Aa, Gg, Gs, Gs, Gs
Sm, Sm, Ds, Gg, Aa, Aa^Fma, Aa^Fma, Aa, Gg, Gg, Gg, Gll, Gg, Rr, Rr, Gd, Gs^Fp, Gg, Rr, Gg, Gg, Gg, Gg, Gg, Rr, Gg, Rr, Rr, Rr, Aa, Rr, Gg, Gg, Gg, Gg, Gg, Gs^Fp, Gs^Fp
Sm, Ds, Gg, Aa, Aa, Aa^Fma, Aa, Aa, Aa, Gg, Gg, Gg, Gg, Gg, Gg, Rr, Rr, Rr, Gg, Rr, Rr, Gg, Gg, Rr, Ce, Rr, Rr, Gg^Vh, Rr, Gg, Rr, Gs, Wwf, Gd, Gd, Gs^Fp, Gll, Gg
Ds, Ds, Gg, Aa, Aa, Aa, Gg, Gg, Gg, Gg, Gg, Gg, Gs^Fp, Gg, Gg, Gg, Gg, Gg, Ss, Gg, Gg, Rr, Rr, Rr, Rr, Rr, Gg, Rr, Gg, Gg, Rr, Aa, Ai, Wwf, Gs, Gs^Fp, Gg^Ve, Gg
Ds, Gg, Gg, Aa, Aa, Gg, Gg^Vh, Gs^Fp, Gs^Fp, Gg, Gg, Gg, Gg^Ve, Gs^Fp, Ss, Ss, Ss, Ss, Ss, Gg, Gg, Gg^Vh, Rr, Rr, Gg, Gg, Gs^Fp, Gg, Gs, Gg, Rr, Aa, Ai, Ai, Gd, Gg, Gs^Fp, Gs^Fp
Gs^Fp, Gg, Gg, Aa, Aa, Gg, Hh, Hh, Hh, Hh, Hh, Gs^Fp, Gs^Fp, Gs^Fp, Gs^Fp, Ss, Gg, Ss, Gg, Gg, Rr, Rr, Gg, Gg, Gg, Gg, Gg, Gg, Gg, Gg, Gg, Aa, Aa, Ai, Aa, Gs, Gs, Gs^Fp
Gs^Fp, Gs^Fp, Gg, Gg, Gg, Hh, Hh, Mm, Mm, Mm, Hh, Hh, Gs^Fp, Gd, Gg, Gg, Gg, Gg, Rr, Rr, Gg, Aa, Aa, Hh, Hh, Hh, Gg, Gg, Aa, Aa, Aa^Fma, Aa, Aa, Aa, Rrd, Rrd, Re, Gd
Ss, Gg^Ve, Gg, Gg, Gg, Hh, Mm, Mm, Mm, Mm, Hh, Hh, Hh, Gg, Gg, Gg, Rr, Rr, Gg, Hh, Gg, Hh, Hh, Hh, Hh, Mm, Ha, Aa, Aa, Aa, Aa, Aa, Aa, Rrd, Rrd, Rrd, Rd, Rd
Gs^Fp, Gs^Fp, Gg, Gg, Gg, Hh, Mm, Mm, Mm, Mm, Mm, Hh, Hh, Gg, Rr, Rr, Gs^Fp, Gs^Fp, Hh, Hh, Hh, Hh, Mm, Mm, Mm, Mm, Mm, Ha, Gg, Gg, Gg, Gg, Rr, Rrd, Rrd, Gd, Gs, Gg
Gg, Gg, Gg, Gg, Gg, Hh, Mm, Mm, Mm, Mm, Mm, Hh, Hh, Hh, Rr, Gg, Gg, Hh, Hh^Vhh, Hh, Hh, Mm, Mm, Mm, Mm, Mm, Mm, Hh, Gg^Vh, Gg, Gg, Gg, Rr, Gd, Gg, Gs, Gg, Gg
Gg, Gg, Gg, Gg, Gg, Gg, Hh, Hh, Hh, Mm, Mm, Hh, Hh, Hh, Aa, Rr, Hh, Hh, Hh, Hh, Mm, Mm, Mm, Mm, Mm, Mm, Mm, Hh, Gg, Gg, Gd, Gg, Rr, Gg, Gg, Gs, Gg, Gg
Aa, Aa, Aa, Gg, Gg, Aa, Aa, Hh, Hh, Hh, Hh, Hh, Hh, Hh, Aa, Rr, Hh, Gs^Fp, Hh, Hh, Hh, Mm, Mm, Mm, Mm, Mm, Mm, Hh, Gd, Gs^Fp, Gg, Gs^Fp, Rr, Gg, Gg, Gg, Gs^Fp, Gs^Fp
Aa, Aa, Aa, Gg, Gg, Gg, Gg, Gg, Gg, Gg, Gg, Gg, Gg^Vh, Gg, Aa, Aa, Gg, Gs, Gs^Fp, Hh, Hh, Hh, Mm, Mm, Mm, Mm, Mm, Hh, Gs^Fp, Gs^Fp, Gg, Gg, Rr, Gg, Gg, Gg, Gs^Fp, Gs^Fp
Aa, Aa, Gg, Gg, Gg, Ss, Ss, Gg, Gg^Ve, Gs^Fp, Gs^Fp, Gg, Gg, Gg, Rr, Aa, Gg, Gg, Gg, Gs^Fp, Hh, Hh, Hh, Hh, Hh, Hh, Hh, Hh, Gg, Gg, Ss, Gg, Ss, Rr, Gg, Gd, Gs^Fp, Gg
Ds, Ds, Gg^Vh, Gg, Gg, Ss, Ss, Gg, Gs^Fp, Gs^Fp, Gs^Fp, Gg, Gg, Gg, Aa, Aa, Aa^Fma, Gg, Gg, Gs^Fp, Hh, Hh, Hh, Hh, Hh, Hh, Gg^Vh, Gg, Gg, Ss, Ss, Ss, Ss, Rr, Gg, Gd, Gs^Fp, Gg
Ds, Ds, Ds, Gs^Fp, Gg, Gg, Gg, Ss, Gs^Fp, Gs^Fp, Gs^Fp, Gd, Gg, Gg, Rr, Aa^Fma, Aa, Aa^Fma, Gg, Gs^Fp, Gs^Fp, Gd, Gs^Fp, Gg, Gg, Gg, Gg, Gg, Gg, Gg, Ss, Ss, Ss, Rr, Gg, Gs^Fp, Gg, Gg
Ww, Ds, Ds, Ds, Ds, Ds, Gg, Gg, Gd, Gs^Fp, Gg, Gg, Re, Re, Rr, Aa, Aa, Aa, Gg, Gs^Fp, Gg^Ve, Gs^Fp, Gs^Fp, Gd, Gd, Gg, Aa, Aa, Aa, Gg, Gg, Ss, Gg, Rr, Gg, Gs^Fp, Ss, Gg
Wo, Ww, Ww, Ds, Ds, Ds, Ds, Ds, Gs^Fp, Gs^Fp, Gg, Re^Dr, Re, Re, Rr, Gg, Aa, Aa, Gg, Gs^Fp, Gs^Fp, Gs^Fp, Gs^Fp, Gd, Gg, Gg, Aa, Gg, Gg, Gg, Gg, Gg, Aa, Rr, Gg, Gs^Fp, Gg^Ve, Gs^Fp
Wo, Wo, Ww, Ww, Ww, Ww, Ww, Ds, Ds, Gs^Fp, Gg, Re, Re, Ch, Ch, Ch, Aa, Aa, Gg, Gg, Gs^Fp, Gs^Fp, Gs^Fp, Gs^Fp, Gg, Gg, Gg, Gg, Gs, Gg, Gg, Ch, Ch, Ch, Gg, Gs^Fp, Gs^Fp, Gs^Fp
Wo, Wo, Wo, Wo, Wo, Wo, Wo, Ww, Ds, Gs^Fp, Gg, Aa, Gg, Ch, 2 Kh, Rr, Gg, Gg, Gg, Gg, Gll, Gs^Fp, Gs^Fp, Gs^Fp, Gg, Gg^Vh, Gg, Gg, Gg, Gg, Gg, Ch, 4 Kh, Rr, Gll, Gs^Fp, Gs^Fp, Gs^Fp
Wo, Wo, Wo, Wo, Wo, Wo, Wo, Wo, Ww, Dd^Vda, Gg, Gg, Gg, Gg, Gg, Gg, Gg, Gs, Gg, Gg, Gg, Gg, Gg, Gll, Gg, Gg, Re, Gg, Gg, Gg, Gg, Gg, Gg, Gg, Gs^Fp, Gs^Fp, Gs^Fp, Ss
Wo, Wo, Wo, Wo, Wo, Wo, Wo, Wo, Wo, Ww, Ds, Gg, Gg, Gg^Vh, Gg, Gg, Gg, Gg, Gg, Gg, Gg, Gg, Gs, Gs, Gs, Gg, Re, Re, Re, Gg, Gg, Gg, Gg, Gg, Gs^Fp, Gg^Ve, Ss, Ss
Wo, Wo, Wo, Wo, Wo, Wo, Wo, Wo, Wo, Wo, Ds, Gg, Gs^Fp, Gs^Fp, Gs^Fp, Gg, Gg, Aa, Aa, Gg, Gg, Gs, Gs, Gs, Re, Re, Re, Re, Aa, Aa, Aa^Fma, Aa, Aa, Gg, Gs^Fp, Gs^Fp, Ss, Ss
Wo, Wo, Wo, Wo, Wo, Wo, Wo, Wo, Wo, Wo, Ds, Gs^Fp, Gs^Fp, Gg^Ve, Gs^Fp, Gg, Gg, Aa, Aa, Gg, Gg, Gs, Gg, Gg, Re, Re, Re, Re, Gg, Aa, Aa, Aa^Fma, Aa, Gg, Gd, Gs^Fp, Ss, Gs^Fp
Wo, Wo, Wo, Wo, Wo, Wo, Wo, Wo, Wo, Wo, Ww, Ds, Gs^Fp, Gs^Fp, Gs^Fp, Gg, Gg, Aa, Aa, Gg, Gg, Gg, Gg, Gg, Gs^Fp, Re, Hh, Gs^Fp, Gg, Gg, Gg, Gg, Aa, Gg, Gg, Gs^Fp, Gs^Fp, Gs^Fp
