Xv, Xv, Xv, Xv, Xv, Xv, Xv, Xv, Xv, Xv, Xv, Xv, Xv, Xv, Xv, Xv, Xv, Xv, Xv, Xv, Xv, Xv, Xv, Xv, Xv, Xv, Xv, Xv, Xv, Xv, Xv, Xv, Xv, Xv, Xv, Xv, Xv, Xv, Xv, Xv, Xv, Xv, Xv, Xv, Xv, Xv, Xv, Xv, Xv, Xv, Xv, Xv, Xv
Xv, Xv, Xv, Xv, Xv, Xv, Xv, Xv, Xv, Xv, Xv, Xv, Xv, Xv, Xv, Xv, Xv, Xv, Xv, Xv, Xv, Xv, Xv, Xv, Xv, Xv, Xv, Xv, Xv, Xv, Xv, Xv, Xv, Xv, Xv, Xv, Xv, Xv, Xv, Xv, Xv, Xv, Xv, Xv, Xv, Xv, Xv, Xv, Xv, Xv, Xv, Xv, Xv
Xv, Xv, Xv, Xv, Xv, Xv, Xv, Xv, Xv, Xv, Xv, Xv, Xv, Xv, Xv, Xv, Xv, Xv, Xv, Xv, Xv, Xv, Xv, Xv, Xv, Xv, Xv, Xv, Xv, Xv, Xv, Xv, Xv, Xv, Xv, Xv, Xv, Xv, Xv, Xv, Xv, Xv, Xv, Xv, Xv, Xv, Xv, Xv, Xv, Xv, Xv, Xv, _off^_usr
Xv, 1 Xv, Xv, Xv, Xv, Xv, Xv, Xv, Xv, Xv, Xv, Xv, Xv, Xv, Xv, Xv, Xv, Xv, Xv, Xv, Xv, Xv, Xv, Xv, Xv, Xv, Xv, Xv, Xv, Xv, Xv, Xv, Xv, Xv, Xv, Xv, Xv, Xv, Xv, Xv, Xv, Xv, Xv, Xv, Xv, Xv, Xv, Xv, Xv, Xv, Xv, Xv, Xv
_off^_usr, 2 _off^_usr, _off^_usr, Xue, Xue, Gd, Gd, Mm, Gs^Fms, Gg^Fms, Gd, Gs, Ce, Gd, Ds, Wwg, Wwg, Wwg, Wwg, Wwf, Wwf, Wwf, Wwf, Wwg, Wwg, Wwg, _off^_usr, Wwg, Wwg, Wwg, Wwf, Wwf, Wwf, Wwf, Wwg, Wwg, Wwg, Wwg, Ds, Gd, Ce, Gs, Gd, Gg^Fms, Gs^Fms, Mm, Gd, Gd, Xue, Xue, _off^_usr, _off^_usr, _off^_usr
_off^_usr, 3 _off^_usr, _off^_usr, _off^_usr, _off^_usr, Xue, Xue, Gs, Gs, Gs, Gs, Gs, Gs, Gd, Gd, Ds, Ds, Wwg, Wwg^Fdw, Wwg, Wwg, Wwf, Wwg, Wwrg, Wwf, Wwg, _off^_usr, Wwg, Wwf, Wwrg, Wwg, Wwf, Wwg, Wwg, Wwg^Fdw, Wwg, Ds, Ds, Gd, Gd, Gs, Gs, Gs, Gs, Gs, Gs, Xue, Xue, _off^_usr, _off^_usr, _off^_usr, _off^_usr, _off^_usr
_off^_usr, 4 _off^_usr, _off^_usr, _off^_usr, _off^_usr, _off^_usr, Xue, Gs, Gs, Gd, Gs, Gs, Gs, Gs, Ce, Gs, Ds, Ww^Ewl, Ww^Ewl, Wwg^Fdw, Wwg, Wwg, Wwg, Wwf, Wwf, Wwg, _off^_usr, Wwg, Wwf, Wwf, Wwg, Wwg, Wwg, Wwg^Fdw, Ww^Ewl, Ww^Ewl, Ds, Gs, Ce, Gs, Gs, Gs, Gs, Gd, Gs, Gs, Xue, _off^_usr, _off^_usr, _off^_usr, _off^_usr, _off^_usr, _off^_usr
_off^_usr, 5 _off^_usr, _off^_usr, _off^_usr, _off^_usr, _off^_usr, _off^_usr, Xue, Gs, Gg, Gs^Fms, Gs, Gs, Gs, Gs, Gs, Ds, Ww^Ewl, Ww^Ewf, Ww^Ewf, Ww^Ewl, Wwg^Fdw, Wwf, Cme, Wwg, Wwg, _off^_usr, Wwg, Wwg, Cme, Wwf, Wwg^Fdw, Ww^Ewl, Ww^Ewf, Ww^Ewf, Ww^Ewl, Ds, Gs, Gs, Gs, Gs, Gs, Gs^Fms, Gg, Gs, Xue, _off^_usr, _off^_usr, _off^_usr, _off^_usr, _off^_usr, _off^_usr, _off^_usr
_off^_usr, 6 _off^_usr, _off^_usr, _off^_usr, _off^_usr, _off^_usr, _off^_usr, Xue, Xue, Gs, Gs^Fms, Hh^Fds, Gs^Fds, Gs, Gs, Gd, Gs, Wwf, Wwf, Wwf, Wwf, Wwf, Hh, Wwf, Wwf, Wwg, _off^_usr, Wwg, Wwf, Wwf, Hh, Wwf, Wwf, Wwf, Wwf, Wwf, Gs, Gd, Gs, Gs, Gs^Fds, Hh^Fds, Gs^Fms, Gs, Xue, Xue, _off^_usr, _off^_usr, _off^_usr, _off^_usr, _off^_usr, _off^_usr, _off^_usr
_off^_usr, 7 _off^_usr, _off^_usr, _off^_usr, _off^_usr, _off^_usr, _off^_usr, _off^_usr, _off^_usr, Gs^Fms, Hh^Fds, Mm, Gs, Gs^Fds, Gs, Gs, Ce, Gs, Wwf, Wwf, Gs, Hh, Mm, Hh^Fds, Mm, Wwf, _off^_usr, Wwf, Mm, Hh^Fds, Mm, Hh, Gs, Wwf, Wwf, Gs, Ce, Gs, Gs, Gs^Fds, Gs, Mm, Hh^Fds, Gs^Fms, _off^_usr, _off^_usr, _off^_usr, _off^_usr, _off^_usr, _off^_usr, _off^_usr, _off^_usr, _off^_usr
_off^_usr, _off^_usr, _off^_usr, _off^_usr, _off^_usr, _off^_usr, _off^_usr, _off^_usr, _off^_usr, Gs^Fms, Mm, Mm, Mm, Gs, Gs, Gs, Gs, Gs, Gs, Gs, Hh^Fds, Hh, Hh^Fms, Mm, Gs^Fms, Hh^Fds, _off^_usr, Hh^Fds, Gs^Fms, Mm, Hh^Fms, Hh, Hh^Fds, Gs, Gs, Gs, Gs, Gs, Gs, Gs, Mm, Mm, Mm, Gs^Fms, _off^_usr, _off^_usr, _off^_usr, _off^_usr, _off^_usr, _off^_usr, _off^_usr, _off^_usr, _off^_usr
_off^_usr, _off^_usr, _off^_usr, _off^_usr, _off^_usr, _off^_usr, _off^_usr, _off^_usr, _off^_usr, _off^_usr, Gs^Fms, Hh^Vh, Hh, Mm, Gs, Gg, Gs^Fds, Gd, Gs, Gs, Gg, Gll^Fp, Gll^Fp, Mm, Gs^Fms, Gs^Fms, _off^_usr, Gs^Fms, Gs^Fms, Mm, Gll^Fp, Gll^Fp, Gg, Gs, Gs, Gd, Gs^Fds, Gg, Gs, Mm, Hh, Hh^Vh, Gs^Fms, _off^_usr, _off^_usr, _off^_usr, _off^_usr, _off^_usr, _off^_usr, _off^_usr, _off^_usr, _off^_usr, _off^_usr
_off^_usr, _off^_usr, _off^_usr, _off^_usr, _off^_usr, _off^_usr, _off^_usr, _off^_usr, _off^_usr, _off^_usr, _off^_usr, Mm, Hh, Hh, Gd, Gs, Gs^Fp, Gs^Fp, Gd, Gs, Gs, Gll^Fp, Gll^Fp, Gll^Fp, Gll^Fp, Gs^Fms, _off^_usr, Gs^Fms, Gll^Fp, Gll^Fp, Gll^Fp, Gll^Fp, Gs, Gs, Gd, Gs^Fp, Gs^Fp, Gs, Gd, Hh, Hh, Mm, _off^_usr, _off^_usr, _off^_usr, _off^_usr, _off^_usr, _off^_usr, _off^_usr, _off^_usr, _off^_usr, _off^_usr, _off^_usr
_off^_usr, _off^_usr, _off^_usr, _off^_usr, _off^_usr, _off^_usr, _off^_usr, _off^_usr, _off^_usr, _off^_usr, _off^_usr, _off^_usr, _off^_usr, Hh^Fds, Gs, Gs^Fp, Hh^Fp, Gs, Ce, Ce, Ce, Gll^Fp, Gs, Gll^Fp, Gs, Gs^Fms, _off^_usr, Gs^Fms, Gs, Gll^Fp, Gs, Gll^Fp, Ce, Ce, Ce, Gs, Hh^Fp, Gs^Fp, Gs, Hh^Fds, _off^_usr, _off^_usr, _off^_usr, _off^_usr, _off^_usr, _off^_usr, _off^_usr, _off^_usr, _off^_usr, _off^_usr, _off^_usr, _off^_usr, _off^_usr
_off^_usr, _off^_usr, _off^_usr, _off^_usr, _off^_usr, _off^_usr, _off^_usr, _off^_usr, _off^_usr, _off^_usr, _off^_usr, _off^_usr, _off^_usr, _off^_usr, _off^_usr, Mm, Hh^Fp, Hh^Fp, Hh^Fp, 8 Kf, Ce, Gg, Gs, Gs, Gd, Gs^Vh, _off^_usr, Gs^Vh, Gd, Gs, Gs, Gg, Ce, 9 Kf, Hh^Fp, Hh^Fp, Hh^Fp, Mm, _off^_usr, _off^_usr, _off^_usr, _off^_usr, _off^_usr, _off^_usr, _off^_usr, _off^_usr, _off^_usr, _off^_usr, _off^_usr, _off^_usr, _off^_usr, _off^_usr, _off^_usr
_off^_usr, _off^_usr, _off^_usr, _off^_usr, _off^_usr, _off^_usr, _off^_usr, _off^_usr, _off^_usr, _off^_usr, _off^_usr, _off^_usr, _off^_usr, _off^_usr, _off^_usr, Mm, Mm, Hh, Hh, Ce, Gs, Gg, Gs, Gs, Gll^Fp, Gs, _off^_usr, Gs, Gll^Fp, Gs, Gs, Gg, Gs, Ce, Hh, Hh, Mm, Mm, _off^_usr, _off^_usr, _off^_usr, _off^_usr, _off^_usr, _off^_usr, _off^_usr, _off^_usr, _off^_usr, _off^_usr, _off^_usr, _off^_usr, _off^_usr, _off^_usr, _off^_usr
_off^_usr, _off^_usr, _off^_usr, _off^_usr, _off^_usr, _off^_usr, _off^_usr, _off^_usr, _off^_usr, _off^_usr, _off^_usr, _off^_usr, _off^_usr, _off^_usr, _off^_usr, _off^_usr, Hh^Fp, Mm, Hh, Gg, Gs, Gs, Gll^Fp, Gll^Fp, Gll^Fp, Gll^Fp, _off^_usr, Gll^Fp, Gll^Fp, Gll^Fp, Gll^Fp, Gs, Gs, Gg, Hh, Mm, Hh^Fp, _off^_usr, _off^_usr, _off^_usr, _off^_usr, _off^_usr, _off^_usr, _off^_usr, _off^_usr, _off^_usr, _off^_usr, _off^_usr, _off^_usr, _off^_usr, _off^_usr, _off^_usr, _off^_usr
_off^_usr, _off^_usr, _off^_usr, _off^_usr, _off^_usr, _off^_usr, _off^_usr, _off^_usr, _off^_usr, _off^_usr, _off^_usr, _off^_usr, _off^_usr, _off^_usr, _off^_usr, _off^_usr, Hh^Fp, Hh^Fp, Mm, Hh^Fp, Mm, Gs, Gs, Gs, Gg, Gs, _off^_usr, Gs, Gg, Gs, Gs, Gs, Mm, Hh^Fp, Mm, Hh^Fp, Hh^Fp, _off^_usr, _off^_usr, _off^_usr, _off^_usr, _off^_usr, _off^_usr, _off^_usr, _off^_usr, _off^_usr, _off^_usr, _off^_usr, _off^_usr, _off^_usr, _off^_usr, _off^_usr, _off^_usr
_off^_usr, _off^_usr, _off^_usr, _off^_usr, _off^_usr, _off^_usr, _off^_usr, _off^_usr, _off^_usr, _off^_usr, _off^_usr, _off^_usr, _off^_usr, _off^_usr, _off^_usr, _off^_usr, _off^_usr, Hh, Mm, Mm, Hh, Mm, Gs, Gs, Gs, Gs, _off^_usr, Gs, Gs, Gs, Gs, Mm, Hh, Mm, Mm, Hh, _off^_usr, _off^_usr, _off^_usr, _off^_usr, _off^_usr, _off^_usr, _off^_usr, _off^_usr, _off^_usr, _off^_usr, _off^_usr, _off^_usr, _off^_usr, _off^_usr, _off^_usr, _off^_usr, _off^_usr
Qlf, Qlf, Qlf, Qlf, Qlf, Qlf, Qlf, Qlf, Qlf, Qlf, Qlf, Qlf, Qlf, Qlf, Qlf, Qlf, Qlf, Qlf, Qlf, Qlf, Qlf, Qlf, Qlf, Qlf, Qlf, Qlf, _off^_usr, Qlf, Qlf, Qlf, Qlf, Qlf, Qlf, Qlf, Qlf, Qlf, Qlf, Qlf, Qlf, Qlf, Qlf, Qlf, Qlf, Qlf, Qlf, Qlf, Qlf, Qlf, Qlf, Qlf, Qlf, Qlf, Qlf
Qlf, Qlf, Qlf, Qlf, Qlf, Qlf, Qlf, Qlf, Qlf, Qlf, Qlf, Qlf, Qlf, Qlf, Qlf, Qlf, Qlf, Qlf, Qlf, Qlf, Qlf, Qlf, Qlf, Qlf, Qlf, Qlf, _off^_usr, Qlf, Qlf, Qlf, Qlf, Qlf, Qlf, Qlf, Qlf, Qlf, Qlf, Qlf, Qlf, Qlf, Qlf, Qlf, Qlf, Qlf, Qlf, Qlf, Qlf, Qlf, Qlf, Qlf, Qlf, Qlf, Qlf
Qlf, Qlf, Qlf, Qlf, Qlf, Qlf, Qlf, Qlf, Qlf, Qlf, Qlf, Qlf, Qlf, Qlf, Qlf, Qlf, Qlf, Qlf, Qlf, Qlf, Qlf, Qlf, Qlf, Qlf, Qlf, Qlf, _off^_usr, Qlf, Qlf, Qlf, Qlf, Qlf, Qlf, Qlf, Qlf, Qlf, Qlf, Qlf, Qlf, Qlf, Qlf, Qlf, Qlf, Qlf, Qlf, Qlf, Qlf, Qlf, Qlf, Qlf, Qlf, Qlf, Qlf
