Gg, Gg, Gg, Qxu, Qxu, Qxu, Qxu, Qxu, Gg, Gg, Gg, Gg, Mm^Xm, Mm^Xm, Mm^Xm, Mm^Xm, Wwf, Wwf, Wwf, Wwg, Wwg, Wwg, Wwg, Wwg, Wwg, Wog, Wog, Wog^Xo, Wog^Xo, Wog^Xo, Wog^Xo, Wog^Xo
Gg, Gg, Gs^Fds, Gg^Fds, Qxu, Qxu, Qxu, Gd, Gg, Gg, Gg, Gs, Mm^Xm, Mm^Xm, Gs^Fds, Wwf, Wwf, Wwf, Gs, Wwf, Wwf, Wwg, Wwg, Wwg, Wwg, Wwg, Wwg, Wog, Wog, Wog^Xo, Wog^Xo, Wog^Xo
Gg, Gg, Qxu^Bh\, Qxu, Qxu, Qxu, Gs, Gs, Gg, Gg^Fds, Gg, Mm^Xm, Gd^Fds, Gd, Wwf, Wwf, Mm, Mm, Gg, Gs^Fds, Gll^Fmf, Wwf, Gg^Fds, Wwg, Wwg, Wwg, Wwg, Wwg, Wwg, Wog, Wog, Wog^Xo
Qxu, Qxu, Qxu, Qxu^Bh\, Qxu^Bh\, Mm, Hh^Fds, Gg, Gs, Gg^Fds, Gg, Gg, Wwf, Wwf, Ss, Wwf, Mm, Gs^Vh, Gll^Fmf, Hh, Gll, Gg^Fds, Ds, Ds, Ce, Wwg, Wwg, Wwg, Wwg, Wwg, Wwg, Wog
Qxu, Qxu, Gg, Qxu, Hh, Gg, Gg, Gg, Wwf, Wwf, Wwf, Wwf, Cv, Cv, Cv, Gg, Mm^Xm, Mm^Xm, Gs, Gg, Gll^Fmf, Ds, Ss, Ds^Es, Ds, Ds, Gg, Wwg, Wwg, Wwg, Wwg, Wwg
Gg^Fds, Gg^Em, Gg, Gd, Gd, Gg^Fds, Gg, Gg, Wwf, Hh^Fds, Hh^Fmf, Wwf, Cv, 8 Kv, Mm^Xm, Mm^Xm, Mm^Xm, Mm^Xm, Gs^Fds, Gs^Fds, Gg^Fds, Ss, Gs^Vh, Ss, Ss, Ds, Cv, Gg, Gs^Fds, Wwg, Wwg, Wwg
Gg, 1 Gg^Fds, Mm, Hh, Wwf, Ss, Gg, Wwf, Wwf, Gg, Gs^Vh, Gg^Fmf, Gs^Fmf, Mm^Xm, Hh, Mm^Xm, Mm^Xm, Mm^Xm, Gg, Mm, Gg^Fds, Gg^Tf, Qxe, Ss, Ss, Gg, Cv, Cv, Kv, Gs^Fds, Gg^Ve, Wwg
Gg^Fds, 2 Gg^Fds, Wwf, Hh, Wwf, Gd, Gg^Fds, Gs^Fds, Wwf, Gg^Fms, Gg^Fms, Gg^Fmf, Gg^Fmf, Mm^Xm, Hh^Fmf, Hh, Hh, Gg^Fds, Gs, Gg, Gg, Qxe, Qxe, Qxe, Gg, Gs, Gg, Cv, Cv, Gg, Gs^Fds, Gg
Gg, 3 Gg^Fds, Gs, Wwf, Gs^Fmf, Wwf, Wwf, Gs^Fds, Wwf, Hh^Fms, Hh, Gs, Gg, Mm^Xm, Hh, Hh, Mm^Xm, Hh, Gs^Fds, Gs^Fds, Gs, Gs, Qxe, Qxe, Gs^Fds, Gs, Gg, Cv, Cv, Gs^Fds, Gs^Fds, Gg
Gg, 4 Gg^Fds, Gg, Gs^Fmf, Hh, Hh, Wwf, Wwf, Gs, Gg, Gd, Gd, Cv, Mm^Xm, Mm^Xm, Mm^Xm, Mm^Xm, Mm^Xm, Gg, Gg^Fds, Gg, Qxe, Qxe, Gs, Gg, Gg, Cv, Cv, Kv, Gg, Gg^Ve, Gg
Gg, 5 Gg^Fds, Gd, Gs^Fmf, Wwf, Hh, Wwf, Gg, Gs^Fds, Gg^Fds, Gd, Gd, Cv, 9 Kv, Cv, Mm^Xm, Mm, Gs^Vh, Gg, Gg, Gs, Qxe, Qxe, Gs, Gg, Gg, Cv, Cv, Gs^Fds, Gs^Fds, Wwg, Wwg
Gg, 6 Gg, Gg^Fds, Gs, Wwf, Wwf, Gg, Gg^Fds, Gg^Fmf, Gs, Hh, Hh^Fds, Gg, Cv, Gs^Fds, Gs^Fds, Gg, Mm^Xm, Gs, Gg, Gs, Hh^Fds, Gs^Vh, Gg, Gs^Fds, Gg, Ds^Es, Ds, Wwg, Wwg, Wwg, Wwg
Gg^Fds, 7 Gg^Fds, Gg, Gg, Wwf, Gg^Fds, Gg^Fds, Gg, Gg^Em, Gg^Fmf, Gg^Fmf, Hh, Gg^Fds, Gs, Hh, Wwf, Wwf, Wwf, Gg^Fds, Ce, Gs^Fds, Hh, Gg, Gg, Ds^Es, Ds, Wwg, Wwg, Wwg, Wwg, Wwg, Wwg
Gg^Fds, Gg, Ss, Wwf, Hh^Fmf, Gd, Gs, Gg, Gd, Gd^Fmf, Hh^Fds, Gs^Vh, Gg, Gg, Wwf, Wwf, Mm^Xm, Wwf, Wwf, Gs^Fds, Wwf, Gg, Ds, Ds, Wwg, Wwg, Wwg, Wwg, Wwg, Wwg, Wog, Wog
Gg, Gg^Fds, Gg^Fds, Wwf, Wwf, Hh, Wwf, Gs, Ss, Hh^Fds, Wwf, Wwf, Wwf, Wwf, Mm^Xm, Mm^Xm, Mm^Xm, Mm^Xm, Wwf, Wwf, Wwf, Ds^Fds, Wwg, Wwg, Wwg, Wwg, Wwg, Wwg, Wog, Wog, Wog^Xo, Wog^Xo
Gg^Fds, Gg^Fds, Gg^Fds, Gg, Gg, Wwf, Wwf, Ss, Ss, Wwf, Gg^Fds, Gg^Fds, Wwf, Wwf, Mm^Xm, Mm^Xm, Mm^Xm, Mm^Xm, Ds, Ds, Wwg, Wwg, Wwg, Wwg, Wwg, Wwg, Wog, Wog, Wog^Xo, Wog^Xo, Wog^Xo, Wog^Xo
Gg, Gg, Gg, Gg^Fds, Gg, Gg^Fds, Gg^Fds, Ss, Ss, Wwf, Wwf, Wwf, Gg, Mm^Xm, Gg, Mm^Xm, Gg, Mm^Xm, Wwg, Wwg, Wwg, Wwg, Wwg, Wwg, Wog, Wog, Wog^Xo, Wog^Xo, Wog^Xo, Wog^Xo, Wog^Xo, Wog^Xo
