Xv, Xv, Xv, Xv, Xv, Xv, Xv, Xv, Xv, Xv, Xv, Xv, Xv, Xv, Xv, Xv, Xv, Xv, Xv, Xv, Xv, Xv, Xv, Xv, Xv, Xv, Xv, Xv, Xv, Xv, Xv, Xv, Xv, Xv, Xv, Xv, Xv, Xv, Xv
Xv, Xv, 3 Xv, 4 Xv, 7 Xv, 8 Xv, Xv, Xv, Xv, Xv, Xv, Xv, Xv, Xv, Xv, Xv, 9 Xv, Xv, Xv, 5 Xv, Xv, Xv, Xv, Xv, Xv, Xv, Xv, Xv, Xv, Xv, Xv, Xv, Xv, Xv, Xv, Xv, Xv, Xv, Xv
Xv, Xv, Xv, Xv, Xv, Xv, Xv, Xv, Xv, Xv, Xv, Xv, Xv, Xv, Xv, Xv, Xv, Xv, Xv, 6 Xv, Xv, Xv, Xv, Xv, Xv, Xv, Xv, Xv, Xv, Xv, Xv, Xv, Xv, Xv, Xv, Xv, Xv, Xv, Xv
Xv, Xv, Xv, Xv, Xv, Xv, Xv, Xv, Mm, Md, Gg, Uue^Tf, Uhe, Uh, Uh, Sm, Sm, Hh, Ss^Fdw, Xv, Ss^Fdw, Hh, Sm, Sm, Uh, Uh, Uhe, Uue^Tf, Gg, Md, Mm, Xv, Xv, Xv, Xv, Xv, Xv, Xv, Xv
Xv, Xv, Xoi, Xoi, Xoi, Xv, Xv, Xv, Gs^Efm, Gs^Efm, Gs^Ft, Uue, Uue, Uue, Uh, Qxu, Gll^Fp, Chs, Wwg, Xv, Wwg, Chs, Gll^Fp, Qxu, Uh, Uue, Uue, Uue, Gs^Ft, Gs^Efm, Gs^Efm, Xv, Xv, Xv, Xoi, Xoi, Xoi, Xv, Xv
Xv, Xoi, Iwc, Iwc, Iwc, Xoi, Xoi, Xv, Gg, Gs^Fts, Gs, Gg, Gs, Gg, Qxu, Qxu, Wwrg, Wwf, Ha, Xv, Ha, Wwf, Wwrg, Qxu, Qxu, Gg, Gs, Gg, Gs, Gs^Fts, Gg, Xv, Xoi, Xoi, Iwc, Iwc, Iwc, Xoi, Xv
Xv, Xoi, Iwc, Iwc, Iwc, Iwc, Xoi, Xv, Gg, Gg, Gs^Es, Gd, Hh, Gg^Fet, Wwf, Wwg, Aa^Fpa, Wwf^Esa, Ai, Xv, Ai, Wwf^Esa, Aa^Fpa, Wwg, Wwf, Gg^Fet, Hh, Gd, Gs^Es, Gg, Gg, Xv, Xoi, Iwc, Iwc, Iwc, Iwc, Xoi, Xv
Xv, Xoi, Iwc, Iwc, Iwc, Iwc, Xoi, Xv, Gs, Gd, Ss, Ss, Wwg, Wwf^Es, Hd, Wwf, Wwg, Aa^Fpa, Aa^Vca, Xv, Aa^Vca, Aa^Fpa, Wwg, Wwf, Hd, Wwf^Es, Wwg, Ss, Ss, Gd, Gs, Xv, Xoi, Iwc, Iwc, Iwc, Iwc, Xoi, Xv
Xv, Xoi, Iwc, Iwc, Iwc, Iwc, Xoi, Xv, Gd, Gs, Gs, Chs, Wwrg, Dd^Ftd, Dd^Ftd, Dd^Vdt, Wwg, Hhd, Re, Xv, Re, Hhd, Wwg, Dd^Vdt, Dd^Ftd, Dd^Ftd, Wwrg, Chs, Gs, Gs, Gd, Xv, Xoi, Iwc, Iwc, Iwc, Iwc, Xoi, Xv
Xv, Xoi, Iwc, Iwc, Iwc, Iwc, Xoi, Xv, Hhd^Fmf, Gd, Gs^Tf, Gd, Gll^Fdf, Mdd, Re^Esd, Wwrg, Wwg^Bw/r, Rd, Ds, Xv, Ds, Rd, Wwg^Bw\r, Wwrg, Re^Esd, Mdd, Gll^Fdf, Gd, Gs^Tf, Gd, Hhd^Fmf, Xv, Xoi, Iwc, Iwc, Iwc, Iwc, Xoi, Xv
Xv, Xoi, Iwc, Iwc, Iwc, Iwc, Xoi, Xv, Uu^Em, Ur, Rr^Vd, Rd, Rd, Re, Rd, Rd, Ds^Dr, Wwg, Ds, Xv, Ds, Wwg, Ds^Dr, Rd, Rd, Re, Rd, Rd, Rr^Vd, Ur, Uu^Em, Xv, Xoi, Iwc, Iwc, Iwc, Iwc, Xoi, Xv
Xv, Xoi, Iwc, Iwc, Iwc, Iwc, Xoi, Xv, Rb, Rb, Gll^Ftr, Rrc, Cer, Rd, Cer, Rd^Esd, Ds, Wwf, Wwf, Xv, Wwf, Wwf, Ds, Rd^Esd, Cer, Rd, Cer, Rrc, Gll^Ftr, Rb, Rb, Xv, Xoi, Iwc, Iwc, Iwc, Iwc, Xoi, Xv
Xv, Xoi, Iwc, Iwc, Iwc, Iwc, Xoi, Xv, Md, Gll^Ftr, Uu, Cer, Hhd^Fdw, 1 Ket, Hhd^Vhhr, Cer, Wwg, Wwf, Wwg, Xv, Wwg, Wwf, Wwg, Cer, Hhd^Vhhr, 2 Ket, Hhd^Fdw, Cer, Uu, Gll^Ftr, Md, Xv, Xoi, Iwc, Iwc, Iwc, Iwc, Xoi, Xv
Xv, Xoi, Xoi, Iwc, Xoi, Xoi, Xv, Xv, Xv, Md, Xv, Uh, Xv, Gll^Fmf, Xv, Wwg, Xv, Wwg, Xv, Xv, Xv, Wwg, Xv, Wwg, Xv, Gll^Fmf, Xv, Uh, Xv, Md, Xv, Xv, Xv, Xoi, Xoi, Iwc, Xoi, Xoi, Xv
Xv, Xv, Xv, Xoi, Xv, Xv, Xv, Xv, Xv, Xv, Xv, Xv, Xv, Xv, Xv, Xv, Xv, Xv, Xv, Xv, Xv, Xv, Xv, Xv, Xv, Xv, Xv, Xv, Xv, Xv, Xv, Xv, Xv, Xv, Xv, Xoi, Xv, Xv, Xv
Xv, Xv, Xv, Xv, Xv, Xv, Xv, Xv, Xv, Xv, Xv, Xv, Xv, Xv, Xv, Xv, Xv, Xv, Xv, Xv, Xv, Xv, Xv, Xv, Xv, Xv, Xv, Xv, Xv, Xv, Xv, Xv, Xv, Xv, Xv, Xv, Xv, Xv, Xv
Xv, Xv, Xv, Xv, Xv, Xv, Xv, Xv, Xv, Xv, Xv, Xv, Xv, Xv, Xv, Xv, Xv, Xv, Xv, Xv, Xv, Xv, Xv, Xv, Xv, Xv, Xv, Xv, Xv, Xv, Xv, Xv, Xv, Xv, Xv, Xv, Xv, Xv, Xv
