Qxu^Xo, Qxu^Xo, Qxu^Xo, Qxu^Xo, Qxu^Xo, Qxu^Xo, Qxu^Xo, Qxu^Xo, Qxu^Xo, Qxu^Xo, Qxu^Xo, Qxu^Xo, Qxu^Xo, Qxu^Xo, Qxu^Xo, Qxu^Xo, Qxu^Xo, Qxu^Xo, Qxu^Xo, Qxu^Xo, Qxu^Xo, Qxu^Xo, Qxu^Xo, Qxu^Xo, Qxu^Xo, Qxu^Xo, Qxu^Xo, Qxu^Xo, Qxu^Xo, Qxu^Xo, Qxu^Xo, Qxu^Xo, Qxu^Xo, Qxu^Xo, Qxu^Xo, Qxu^Xo, Qxu^Xo, Qxu^Xo, Qxu^Xo
Qxu^Xo, Qxu^Xo, Qxu^Xo, 4 Qxu^Xo, 7 Qxu^Xo, 8 Qxu^Xo, Qxu^Xo, Qxu^Xo, Qxu^Xo, Qxu^Xo, Qxu^Xo, Qxu^Xo, Qxu^Xo, Qxu^Xo, Qxu^Xo, Qxu^Xo, 9 Qxu^Xo, Qxu^Xo, Qxu^Xo, 5 Qxu^Xo, Qxu^Xo, Qxu^Xo, Qxu^Xo, Qxu^Xo, Qxu^Xo, Qxu^Xo, Qxu^Xo, Qxu^Xo, Qxu^Xo, Qxu^Xo, Qxu^Xo, Qxu^Xo, Qxu^Xo, Qxu^Xo, Qxu^Xo, Qxu^Xo, Qxu^Xo, Qxu^Xo, Qxu^Xo
Qxu^Xo, Qxu^Xo, Qxu^Xo, Qxu^Xo, Qxu^Xo, Qxu^Xo, Qxu^Xo, Qxu^Xo, Qxu^Xo, Qxu^Xo, Qxu^Xo, Qxu^Xo, Qxu^Xo, Qxu^Xo, Qxu^Xo, Qxu^Xo, Qxu^Xo, Qxu^Xo, Qxu^Xo, 6 Qxu^Xo, Qxu^Xo, Qxu^Xo, Qxu^Xo, Qxu^Xo, Qxu^Xo, Qxu^Xo, Qxu^Xo, Qxu^Xo, Qxu^Xo, Qxu^Xo, Qxu^Xo, Qxu^Xo, Qxu^Xo, Qxu^Xo, Qxu^Xo, Qxu^Xo, Qxu^Xo, Qxu^Xo, Qxu^Xo
Qxu^Xo, Qxu^Xo, Qxu^Xo, Qxu^Xo, Qxu^Xo, Qxu^Xo, Qxu^Xo, Qxu^Xo, Mm, Md, Gg, Uue^Tf, Uhe, Uh, Uh, Sm, Sm, Hh, Ss^Fdw, Qxu^Xo, Ss^Fdw, Hh, Sm, Sm, Uh, Uh, Uhe, Uue^Tf, Gg, Md, Mm, Qxu^Xo, Qxu^Xo, Qxu^Xo, Qxu^Xo, Qxu^Xo, Qxu^Xo, Qxu^Xo, Qxu^Xo
Qxu^Xo, Qxu^Xo, Xoi, Xoi, Xoi, Qxu^Xo, Qxu^Xo, Qxu^Xo, Gs^Efm, Gs^Efm, Gs^Ft, Uue, Uue, Uue, Uh, Qxu, Gll^Fp, Chs, Wwg, Qxu^Xo, Wwg, Chs, Gll^Fp, Qxu, Uh, Uue, Uue, Uue, Gs^Ft, Gs^Efm, Gs^Efm, Qxu^Xo, Qxu^Xo, Qxu^Xo, Xoi, Xoi, Xoi, Qxu^Xo, Qxu^Xo
Qxu^Xo, Xoi, Iwc, Iwc, Iwc, Xoi, Xoi, Qxu^Xo, Gg, Gs^Fts, Gs, Gg, Gs, Gg, Qxu, Qxu, Wwrg, Wwf, Ha, Qxu^Xo, Ha, Wwf, Wwrg, Qxu, Qxu, Gg, Gs, Gg, Gs, Gs^Fts, Gg, Qxu^Xo, Xoi, Xoi, Iwc, Iwc, Iwc, Xoi, Qxu^Xo
Qxu^Xo, Xoi, Iwc, Iwc, Iwc, Iwc, Xoi, Qxu^Xo, Gg, Gg, Gs^Es, Gd, Hh, Gg^Fet, Wwf, Wwg, Aa^Fpa, Wwf^Esa, Ai, Qxu^Xo, Ai, Wwf^Esa, Aa^Fpa, Wwg, Wwf, Gg^Fet, Hh, Gd, Gs^Es, Gg, Gg, Qxu^Xo, Xoi, Iwc, Iwc, Iwc, Iwc, Xoi, Qxu^Xo
Qxu^Xo, Xoi, Iwc, Iwc, Iwc, Iwc, Xoi, Qxu^Xo, Gs, Gd, Ss, Ss, Wwg, Wwf^Es, Hd, Wwf, Wwg, Aa^Fpa, Aa^Vca, Qxu^Xo, Aa^Vca, Aa^Fpa, Wwg, Wwf, Hd, Wwf^Es, Wwg, Ss, Ss, Gd, Gs, Qxu^Xo, Xoi, Iwc, Iwc, Iwc, Iwc, Xoi, Qxu^Xo
Qxu^Xo, Xoi, Iwc, Iwc, Iwc, Iwc, Xoi, Qxu^Xo, Gd, Gs, Gs, Chs, Wwrg, Dd^Ftd, Dd^Ftd, Dd^Vdt, Wwg, Hhd, Re, Qxu^Xo, Re, Hhd, Wwg, Dd^Vdt, Dd^Ftd, Dd^Ftd, Wwrg, Chs, Gs, Gs, Gd, Qxu^Xo, Xoi, Iwc, Iwc, Iwc, Iwc, Xoi, Qxu^Xo
Qxu^Xo, Xoi, Iwc, Iwc, Iwc, Iwc, Xoi, Qxu^Xo, Hhd^Fmf, Gd, Gs^Tf, Gd, Gll^Fdf, Mdd, Re^Esd, Wwrg, Wwg^Bw/r, Rd, Ds, Qxu^Xo, Ds, Rd, Wwg^Bw\r, Wwrg, Re^Esd, Mdd, Gll^Fdf, Gd, Gs^Tf, Gd, Hhd^Fmf, Qxu^Xo, Xoi, Iwc, Iwc, Iwc, Iwc, Xoi, Qxu^Xo
Qxu^Xo, Xoi, Iwc, Iwc, Iwc, Iwc, Xoi, Qxu^Xo, Uu^Em, Ur, Rr^Vd, Rd, Rd, Re, Rd, Rd, Ds^Dr, Wwg, Ds, Qxu^Xo, Ds, Wwg, Ds^Dr, Rd, Rd, Re, Rd, Rd, Rr^Vd, Ur, Uu^Em, Qxu^Xo, Xoi, Iwc, Iwc, Iwc, Iwc, Xoi, Qxu^Xo
Qxu^Xo, Xoi, Iwc, Iwc, Iwc, Iwc, Xoi, Qxu^Xo, Rb, Rb, Gll^Ftr, Rrc, Cer, Rd, Cer, Rd^Esd, Ds, Wwf, Wwf, Qxu^Xo, Wwf, Wwf, Ds, Rd^Esd, Cer, Rd, Cer, Rrc, Gll^Ftr, Rb, Rb, Qxu^Xo, Xoi, Iwc, Iwc, Iwc, Iwc, Xoi, Qxu^Xo
Qxu^Xo, Xoi, Iwc, Iwc, Iwc, Iwc, Xoi, Qxu^Xo, Md, Gll^Ftr, Uu, Cer, Hhd^Fdw, 1 Ket, Hhd^Vhhr, Cer, Wwg, Wwf, Wwg, Qxu^Xo, Wwg, Wwf, Wwg, Cer, Hhd^Vhhr, 2 Ket, Hhd^Fdw, Cer, Uu, Gll^Ftr, Md, Qxu^Xo, Xoi, Iwc, Iwc, Iwc, Iwc, Xoi, Qxu^Xo
Qxu^Xo, Xoi, Xoi, Iwc, Xoi, Xoi, Qxua, Qxe^Xo, Qxe^Xo, Md, Qlf^Xo, Uh, Qlf^Xo, Gll^Fmf, Qlf^Xo, Wwg, Qlf^Xo, Wwg, Qlf^Xo, Qlf^Xo, Qlf^Xo, Wwg, Qlf^Xo, Wwg, Qlf^Xo, Gll^Fmf, Qlf^Xo, Uh, Qlf^Xo, Md, Qxu^Xo, Qxu^Xo, Qxu^Xo, Xoi, Xoi, Iwc, Xoi, Xoi, Qxu^Xo
Qxu^Xo, Xoi, Xoi, Xoi, Xoi, Qxua, Qxe^Xo, Qxe^Xo, Qxe^Xo, Qlf^Xo, Qlf^Xo, Qlf^Xo, Qlf^Xo, Qlf^Xo, Qlf^Xo, Qlf^Xo, Qlf^Xo, Qlf^Xo, Qlf^Xo, Qlf^Ecf, Qlf^Xo, Qlf^Xo, Qlf^Xo, Qlf^Xo, Qlf^Xo, Qlf^Xo, Qlf^Xo, Qlf^Xo, Qlf^Xo, Qlf^Xo, Qxu^Xo, Qxu^Xo, Qxu^Xo, Qxu^Xo, Qxu^Xo, Xoi, Qxu^Xo, Qxu^Xo, Qxu^Xo
Qxu^Xo, Xoi, Iwc, Iwc, Iwc, Xoi, Xoi, Qxe^Xo, Md, Md, Uu, Uh, Hhd^Fdw, Gll^Fmf, Hhd^Vhhr, Wwg, Wwg, Wwg, Wwg, Qlf^Xo, Wwg, Wwg, Wwg, Wwg, Hh, Gll^Fmf, Hhd^Fdw, Uh, Uu, Md, Md, Qxu^Xo, Qxu^Xo, Qxu^Xo, Qxu^Xo, Qxu^Xo, Qxu^Xo, Qxu^Xo, Qxu^Xo
Qxu^Xo, Xoi, Iwc, Iwc, Iwc, Iwc, Xoi, Qxu^Xo, Rb, Gll^Ftr, Gll^Ftr, Cer, Cer, 3 Ket, Cer, Cer, Ds, Wwf, Wwf, Qxu^Xo, Wwf, Wwf, Ds, Gll^Ftr, Ss, Ss, Gll^Ftr, Gll^Ftr, Gll^Ftr, Gll^Ftr, Rb, Qxu^Xo, Qxu^Xo, Qxu^Xo, Qxu^Xo, Qxu^Xo, Qxu^Xo, Qxu^Xo, Qxu^Xo
Qxu^Xo, Xoi, Iwc, Iwc, Iwc, Iwc, Xoi, Qxu^Xo, Uu^Em, Rb, Rr^Vd, Rrc, Rd, Rd, Rd, Rd^Esd, Ds^Dr, Wwf, Ds, Qxu^Xo, Ds, Wwf, Ds^Dr, Rd^Esd, Rd, Rd, Rd, Rrc, Rra, Rb, Uu^Em, Qxu^Xo, Qxu^Xo, Qxu^Xo, Qxu^Xo, Qxu^Xo, Qxu^Xo, Qxu^Xo, Qxu^Xo
Qxu^Xo, Xoi, Iwc, Iwc, Iwc, Iwc, Xoi, Qxu^Xo, Hhd^Fmf, Ur, Gs^Tf, Rd, Gll^Fdf, Re, Re^Esd, Rd, Wwg^Bw\r, Wwg, Ds, Qxu^Xo, Ds, Wwg, Wwg^Bw/, Rd, Re^Esd, Re, Gll^Fdf, Rd, Gs^Tf, Ur, Hhd^Fmf, Qxu^Xo, Qxu^Xo, Qxu^Xo, Qxu^Xo, Qxu^Xo, Qxu^Xo, Qxu^Xo, Qxu^Xo
Qxu^Xo, Xoi, Iwc, Iwc, Iwc, Iwc, Xoi, Qxu^Xo, Gd, Gd, Gs, Gd, Wwrg, Mdd, Dd^Ftd, Wwrg, Wwg, Rd, Re, Qxu^Xo, Re, Rd, Wwg, Wwrg, Dd^Ftd, Mdd, Wwrg, Gd, Gs, Gd, Gd, Qxu^Xo, Qxu^Xo, Qxu^Xo, Qxu^Xo, Qxu^Xo, Qxu^Xo, Qxu^Xo, Qxu^Xo
Qxu^Xo, Xoi, Iwc, Iwc, Iwc, Iwc, Xoi, Qxu^Xo, Gs, Gs, Ss, Chs, Wwg, Dd^Ftd, Hd, Dd^Vdt, Wwg, Hhd, Aa^Vca, Qxu^Xo, Aa, Hhd, Wwg, Dd, Hd, Dd^Ftd, Wwg, Chs, Ss, Gs, Gs, Qxu^Xo, Qxu^Xo, Qxu^Xo, Qxu^Xo, Qxu^Xo, Qxu^Xo, Qxu^Xo, Qxu^Xo
Qxu^Xo, Xoi, Iwc, Iwc, Iwc, Iwc, Xoi, Qxu^Xo, Gg, Gd, Gs^Es, Ss, Hh, Wwf^Es, Wwf, Wwf, Aa^Fpa, Aa^Fpa, Ai, Qxu^Xo, Ai, Aa^Fpa, Aa^Fpa, Wwf, Wwf, Wwf^Es, Hh, Ss, Gs^Es, Gd, Gg, Qxu^Xo, Qxu^Xo, Qxu^Xo, Qxu^Xo, Qxu^Xo, Qxu^Xo, Qxu^Xo, Qxu^Xo
Qxu^Xo, Xoi, Iwc, Iwc, Iwc, Iwc, Xoi, Qxu^Xo, Gg, Gg, Gs, Gd, Gs, Gg^Fet, Qxu, Wwg, Wwrg, Wwf^Esa, Ha, Qxu^Xo, Ha, Wwf^Esa, Wwrg, Wwg, Qxu, Gg^Fet, Gs, Gd, Gs, Gg, Gg, Qxu^Xo, Qxu^Xo, Qxu^Xo, Qxu^Xo, Qxu^Xo, Qxu^Xo, Qxu^Xo, Qxu^Xo
Qxu^Xo, Xoi, Xoi, Iwc, Xoi, Xoi, Qxu^Xo, Qxu^Xo, Gs^Efm, Gs^Fts, Gs^Ft, Gg, Uue, Gg, Uh, Qxu, Gll^Fp, Wwf, Wwg, Qxu^Xo, Wwg, Wwf, Gll^Fp, Qxu, Uh, Gg, Uue, Gg, Gs^Ft, Gs^Fts, Gs^Efm, Qxu^Xo, Qxu^Xo, Qxu^Xo, Qxu^Xo, Qxu^Xo, Qxu^Xo, Qxu^Xo, Qxu^Xo
Qxu^Xo, Qxu^Xo, Qxu^Xo, Xoi, Qxu^Xo, Qxu^Xo, Qxu^Xo, Qxu^Xo, Mm, Gs^Efm, Gg, Uue, Uhe, Uue, Uh, Qxu, Sm, Chs, Ss^Fdw, Qxu^Xo, Ss^Fdw, Chs, Sm, Qxu, Uh, Uue, Uhe, Uue, Gg, Gs^Efm, Mm, Qxu^Xo, Qxu^Xo, Qxu^Xo, Qxu^Xo, Qxu^Xo, Qxu^Xo, Qxu^Xo, Qxu^Xo
Qxu^Xo, Qxu^Xo, Qxu^Xo, Qxu^Xo, Qxu^Xo, Qxu^Xo, Qxu^Xo, Qxu^Xo, Qxu^Xo, Md, Qxu^Xo, Uue^Tf, Qxu^Xo, Uh, Qxu^Xo, Sm, Qxu^Xo, Hh, Qxu^Xo, Qxu^Xo, Qxu^Xo, Hh, Qxu^Xo, Sm, Qxu^Xo, Uh, Qxu^Xo, Uue^Tf, Qxu^Xo, Md, Qxu^Xo, Qxu^Xo, Qxu^Xo, Qxu^Xo, Qxu^Xo, Qxu^Xo, Qxu^Xo, Qxu^Xo, Qxu^Xo
Qxu^Xo, Qxu^Xo, Qxu^Xo, Qxu^Xo, Qxu^Xo, Qxu^Xo, Qxu^Xo, Qxu^Xo, Qxu^Xo, Qxu^Xo, Qxu^Xo, Qxu^Xo, Qxu^Xo, Qxu^Xo, Qxu^Xo, Qxu^Xo, Qxu^Xo, Qxu^Xo, Qxu^Xo, Qxu^Xo, Qxu^Xo, Qxu^Xo, Qxu^Xo, Qxu^Xo, Qxu^Xo, Qxu^Xo, Qxu^Xo, Qxu^Xo, Qxu^Xo, Qxu^Xo, Qxu^Xo, Qxu^Xo, Qxu^Xo, Qxu^Xo, Qxu^Xo, Qxu^Xo, Qxu^Xo, Qxu^Xo, Qxu^Xo
Qxu^Xo, Qxu^Xo, Qxu^Xo, Qxu^Xo, Qxu^Xo, Qxu^Xo, Qxu^Xo, Qxu^Xo, Qxu^Xo, Qxu^Xo, Qxu^Xo, Qxu^Xo, Qxu^Xo, Qxu^Xo, Qxu^Xo, Qxu^Xo, Qxu^Xo, Qxu^Xo, Qxu^Xo, Qxu^Xo, Qxu^Xo, Qxu^Xo, Qxu^Xo, Qxu^Xo, Qxu^Xo, Qxu^Xo, Qxu^Xo, Qxu^Xo, Qxu^Xo, Qxu^Xo, Qxu^Xo, Qxu^Xo, Qxu^Xo, Qxu^Xo, Qxu^Xo, Qxu^Xo, Qxu^Xo, Qxu^Xo, Qxu^Xo
